Rk,Player,Gls,Season,Age,Nation,Team,Comp,MP,Min,90s,Starts,Subs,unSub,Gls.1,Ast,G+A,G-PK,PK,PKatt,PKm,Pos,-9999,Starter_Category
1,Robert Lewandowski,41,2020-2021,31,pl POL,Bayern Munich,de Bundesliga,29,2458,27.3,28,1,0,41,7,48,33,8,9,1,FW,8d78e732,Full Starter
2,Erling Haaland,36,2022-2023,22,no NOR,Manchester City,eng Premier League,35,2769,30.8,33,2,1,36,8,44,29,7,7,0,FW,1f44ac21,Full Starter
3,Harry Kane,36,2023-2024,30,eng ENG,Bayern Munich,de Bundesliga,32,2839,31.5,32,0,0,36,8,44,31,5,5,0,FW,21a66f6a,Full Starter
4,Robert Lewandowski,35,2021-2022,32,pl POL,Bayern Munich,de Bundesliga,34,2946,32.7,34,0,0,35,3,38,30,5,5,0,FW,8d78e732,Full Starter
5,Harry Kane,30,2022-2023,29,eng ENG,Tottenham,eng Premier League,38,3405,37.8,38,0,0,30,3,33,25,5,6,1,FW,21a66f6a,Full Starter
6,Lionel Messi,30,2020-2021,33,ar ARG,Barcelona,es La Liga,35,3023,33.6,33,2,0,30,9,39,27,3,5,2,FWMF,d70ce98e,Full Starter
7,Kylian Mbappé,29,2022-2023,23,fr FRA,Paris S-G,fr Ligue 1,34,2818,31.3,32,2,0,29,5,34,26,3,5,2,FW,42fd9c7f,Full Starter
8,Cristiano Ronaldo,29,2020-2021,35,pt POR,Juventus,it Serie A,33,2802,31.1,31,2,1,29,2,31,23,6,8,2,FW,dea698d9,Full Starter
9,André Silva,28,2020-2021,24,pt POR,Eint Frankfurt,de Bundesliga,32,2760,30.7,32,0,0,28,7,35,21,7,7,0,FW,3effaa34,Rotational Player
10,Kylian Mbappé,28,2021-2022,22,fr FRA,Paris S-G,fr Ligue 1,35,3023,33.6,34,1,0,28,17,45,24,4,4,0,FW,42fd9c7f,Full Starter
11,Serhou Guirassy,28,2023-2024,27,gn GUI,Stuttgart,de Bundesliga,28,2208,24.5,25,3,0,28,3,31,24,4,4,0,FW,923f4dda,Rotational Player
12,Erling Haaland,27,2020-2021,20,no NOR,Dortmund,de Bundesliga,28,2407,26.7,27,1,0,27,6,33,25,2,4,2,FW,1f44ac21,Full Starter
13,Erling Haaland,27,2023-2024,23,no NOR,Manchester City,eng Premier League,31,2552,28.4,29,2,1,27,5,32,20,7,8,1,FW,1f44ac21,Full Starter
14,Kylian Mbappé,27,2023-2024,24,fr FRA,Paris S-G,fr Ligue 1,29,2158,24.0,24,5,2,27,7,34,21,6,8,2,FW,42fd9c7f,Full Starter
15,Kylian Mbappé,27,2020-2021,21,fr FRA,Paris S-G,fr Ligue 1,31,2380,26.4,27,4,0,27,7,34,21,6,6,0,FW,42fd9c7f,Full Starter
16,Ciro Immobile,27,2021-2022,31,it ITA,Lazio,it Serie A,31,2711,30.1,31,0,0,27,2,29,20,7,9,2,FW,4431aed2,Full Starter
17,Karim Benzema,27,2021-2022,33,fr FRA,Real Madrid,es La Liga,32,2593,28.8,31,1,1,27,12,39,20,7,11,4,FW,70d74ece,Full Starter
18,Alexandre Lacazette,27,2022-2023,31,fr FRA,Lyon,fr Ligue 1,35,2929,32.5,34,1,0,27,5,32,21,6,8,2,FW,9dbb75ca,Rotational Player
19,Victor Osimhen,26,2022-2023,23,ng NGA,Napoli,it Serie A,32,2566,28.5,30,2,0,26,4,30,24,2,3,1,FW,8c90fd7a,Rotational Player
20,Wissam Ben Yedder,25,2021-2022,30,fr FRA,Monaco,fr Ligue 1,37,2529,28.1,29,8,0,25,5,30,17,8,8,0,FW,942b4f90,Full Starter
21,Artem Dovbyk,24,2023-2024,26,ua UKR,Girona,es La Liga,36,2587,28.7,32,4,0,24,8,32,17,7,8,1,FW,5b847bb0,Full Starter
22,Patrik Schick,24,2021-2022,25,cz CZE,Leverkusen,de Bundesliga,27,2076,23.1,26,1,0,24,3,27,23,1,2,1,FW,5d4f7d61,Rotational Player
23,Romelu Lukaku,24,2020-2021,27,be BEL,Inter,it Serie A,36,2884,32.0,32,4,1,24,11,35,18,6,6,0,FW,5eae500a,Rotational Player
24,Dušan Vlahović,24,2021-2022,21,rs SRB,2 Teams,it Serie A,36,2933,32.6,33,3,0,24,3,27,19,5,6,1,FW,79443529,Full Starter
25,Loïs Openda,24,2023-2024,23,be BEL,RB Leipzig,de Bundesliga,34,2697,30.0,33,1,0,24,7,31,22,2,3,1,FW,8652a85c,Full Starter
26,Jonathan David,24,2022-2023,22,ca CAN,Lille,fr Ligue 1,37,3166,35.2,36,1,0,24,4,28,14,10,11,1,FW,ce50fd99,Full Starter
27,Lautaro Martínez,24,2023-2024,25,ar ARG,Inter,it Serie A,33,2656,29.5,31,2,2,24,3,27,22,2,3,1,FW,f7036e1c,Full Starter
28,Harry Kane,23,2020-2021,27,eng ENG,Tottenham,eng Premier League,35,3082,34.2,35,0,0,23,14,37,19,4,4,0,FW,21a66f6a,Full Starter
29,Karim Benzema,23,2020-2021,32,fr FRA,Real Madrid,es La Liga,34,2894,32.2,33,1,0,23,9,32,22,1,1,0,FW,70d74ece,Full Starter
30,Gerard Moreno,23,2020-2021,28,es ESP,Villarreal,es La Liga,33,2673,29.7,30,3,0,23,7,30,13,10,10,0,FW,81f0781e,Rotational Player
31,Robert Lewandowski,23,2022-2023,33,pl POL,Barcelona,es La Liga,34,2847,31.6,33,1,0,23,7,30,23,0,1,1,FW,8d78e732,Full Starter
32,Son Heung-min,23,2021-2022,29,kr KOR,Tottenham,eng Premier League,35,3006,33.4,35,0,0,23,7,30,23,0,0,0,MFFW,92e7e919,Full Starter
33,Mohamed Salah,23,2021-2022,29,eg EGY,Liverpool,eng Premier League,35,2762,30.7,30,5,0,23,13,36,18,5,6,1,FW,e342ad68,Full Starter
34,Alexander Sørloth,23,2023-2024,27,no NOR,Villarreal,es La Liga,34,2489,27.7,30,4,1,23,6,29,23,0,0,0,FW,e92cd3f7,Rotational Player
35,Erling Haaland,22,2021-2022,21,no NOR,Dortmund,de Bundesliga,24,1911,21.2,21,3,0,22,8,30,16,6,6,0,FW,1f44ac21,Full Starter
36,Cole Palmer,22,2023-2024,21,eng ENG,2 Teams,eng Premier League,34,2618,29.1,29,5,2,22,11,33,13,9,9,0,FWMF,dc7f8a28,Full Starter
37,Mohamed Salah,22,2020-2021,28,eg EGY,Liverpool,eng Premier League,37,3078,34.2,34,3,0,22,5,27,16,6,6,0,FW,e342ad68,Full Starter
38,Luis Muriel,22,2020-2021,29,co COL,Atalanta,it Serie A,36,1436,16.0,16,20,1,22,7,29,20,2,3,1,FW,eb2fe5b6,Rotational Player
39,Folarin Balogun,21,2022-2023,21,us USA,Reims,fr Ligue 1,37,2999,33.3,34,3,0,21,2,23,15,6,7,1,FW,31822f8c,Rotational Player
40,Martin Terrier,21,2021-2022,24,fr FRA,Rennes,fr Ligue 1,37,2779,30.9,37,0,0,21,3,24,19,2,2,0,FWMF,5148dcc5,Full Starter
41,Dušan Vlahović,21,2020-2021,20,rs SRB,Fiorentina,it Serie A,37,2923,32.5,34,3,1,21,3,24,15,6,6,0,FW,79443529,Full Starter
42,Loïs Openda,21,2022-2023,22,be BEL,Lens,fr Ligue 1,38,2517,28.0,29,9,0,21,4,25,20,1,1,0,FW,8652a85c,Full Starter
43,Alexander Isak,21,2023-2024,23,se SWE,Newcastle Utd,eng Premier League,30,2255,25.1,27,3,1,21,2,23,16,5,6,1,FW,8e92be30,Rotational Player
44,Luis Suárez,21,2020-2021,33,uy URU,Atlético Madrid,es La Liga,32,2508,27.9,30,2,0,21,3,24,18,3,3,0,FW,a6154613,Rotational Player
45,Moussa Dembélé,21,2021-2022,25,fr FRA,Lyon,fr Ligue 1,30,2207,24.5,25,5,0,21,4,25,16,5,5,0,FW,e7986081,Rotational Player
46,Lautaro Martínez,21,2021-2022,23,ar ARG,Inter,it Serie A,35,2282,25.4,28,7,1,21,3,24,18,3,6,3,FW,f7036e1c,Full Starter
47,Lautaro Martínez,21,2022-2023,24,ar ARG,Inter,it Serie A,38,2576,28.6,27,11,0,21,6,27,20,1,2,1,FW,f7036e1c,Full Starter
48,Anthony Modeste,20,2021-2022,33,fr FRA,Köln,de Bundesliga,32,2606,29.0,31,1,0,20,4,24,19,1,1,0,FW,34e4343c,Full Starter
49,Ciro Immobile,20,2020-2021,30,it ITA,Lazio,it Serie A,35,2849,31.7,34,1,0,20,6,26,16,4,8,4,FW,4431aed2,Full Starter
50,Andrej Kramarić,20,2020-2021,29,hr CRO,Hoffenheim,de Bundesliga,28,2379,26.4,26,2,0,20,5,25,15,5,5,0,FWMF,603cb947,Rotational Player
51,Habib Diallo,20,2022-2023,27,sn SEN,Strasbourg,fr Ligue 1,37,2879,32.0,32,5,0,20,1,21,17,3,4,1,FW,6605d143,Full Starter
52,Christopher Nkunku,20,2021-2022,23,fr FRA,RB Leipzig,de Bundesliga,34,2723,30.3,31,3,0,20,13,33,19,1,1,0,FWMF,7c56da38,Rotational Player
53,Simeon Nwankwo,20,2020-2021,28,ng NGA,Crotone,it Serie A,38,2943,32.7,31,7,0,20,2,22,12,8,8,0,FW,80dbbd10,Rotational Player
54,Memphis,20,2020-2021,26,nl NED,Lyon,fr Ligue 1,37,2923,32.5,33,4,0,20,12,32,12,8,8,0,FW,8f696594,Rotational Player
55,Wissam Ben Yedder,20,2020-2021,29,fr FRA,Monaco,fr Ligue 1,37,2607,29.0,32,5,0,20,7,27,10,10,12,2,FW,942b4f90,Full Starter
56,Wout Weghorst,20,2020-2021,27,nl NED,Wolfsburg,de Bundesliga,34,2941,32.7,33,1,0,20,8,28,18,2,3,1,FW,c4e87b8b,Full Starter
57,Ivan Toney,20,2022-2023,26,eng ENG,Brentford,eng Premier League,33,2951,32.8,33,0,0,20,4,24,14,6,7,1,FW,e09f279b,Full Starter
58,Elye Wahi,19,2022-2023,19,fr FRA,Montpellier,fr Ligue 1,33,2513,27.9,29,4,0,19,5,24,18,1,1,0,FW,0d7b6576,Rotational Player
59,Lorenzo Insigne,19,2020-2021,29,it ITA,Napoli,it Serie A,35,2865,31.8,33,2,0,19,8,27,12,7,8,1,FW,2f557579,Full Starter
60,Jude Bellingham,19,2023-2024,20,eng ENG,Real Madrid,es La Liga,28,2315,25.7,27,1,4,19,6,25,18,1,1,0,MF,57d88cf9,Full Starter
61,Karim Benzema,19,2022-2023,34,fr FRA,Real Madrid,es La Liga,24,2038,22.6,24,0,0,19,3,22,12,7,8,1,FW,70d74ece,Full Starter
62,Robert Lewandowski,19,2023-2024,34,pl POL,Barcelona,es La Liga,35,2750,30.6,32,3,0,19,8,27,15,4,4,0,FW,8d78e732,Full Starter
63,Wissam Ben Yedder,19,2022-2023,31,fr FRA,Monaco,fr Ligue 1,32,2114,23.5,28,4,4,19,6,25,14,5,6,1,FW,942b4f90,Full Starter
64,Alexandre Lacazette,19,2023-2024,32,fr FRA,Lyon,fr Ligue 1,29,2293,25.5,27,2,0,19,2,21,17,2,2,0,FW,9dbb75ca,Rotational Player
65,Ollie Watkins,19,2023-2024,27,eng ENG,Aston Villa,eng Premier League,37,3217,35.7,37,0,0,19,13,32,19,0,0,0,FW,aed3a70f,Full Starter
66,Jonathan David,19,2023-2024,23,ca CAN,Lille,fr Ligue 1,34,2629,29.2,30,4,0,19,4,23,17,2,3,1,FW,ce50fd99,Full Starter
67,Mohamed Salah,19,2022-2023,30,eg EGY,Liverpool,eng Premier League,38,3290,36.6,37,1,0,19,12,31,17,2,4,2,FW,e342ad68,Full Starter
68,Mohamed Salah,19,2024-2025,32,eg EGY,Liverpool,eng Premier League,22,1942,21.6,22,0,0,19,13,32,14,5,5,0,FW,e342ad68,Full Starter
69,Dominic Solanke,19,2023-2024,25,eng ENG,Bournemouth,eng Premier League,38,3325,36.9,37,1,0,19,3,22,17,2,3,1,FW,e77dc3b2,Full Starter
70,Phil Foden,19,2023-2024,23,eng ENG,Manchester City,eng Premier League,35,2857,31.7,33,2,2,19,8,27,19,0,0,0,FWMF,ed1e53f3,Rotational Player
71,Youssef En-Nesyri,18,2020-2021,23,ma MAR,Sevilla,es La Liga,38,2311,25.7,23,15,0,18,0,18,18,0,0,0,FW,04e17fd5,Rotational Player
72,Terem Moffi,18,2022-2023,23,ng NGA,2 Teams,fr Ligue 1,34,2714,30.2,32,2,0,18,3,21,17,1,2,1,FW,065dc209,Full Starter
73,Erling Haaland,18,2024-2025,24,no NOR,Manchester City,eng Premier League,23,2034,22.6,23,0,0,18,2,20,17,1,2,1,FW,1f44ac21,Full Starter
74,Bruno Fernandes,18,2020-2021,25,pt POR,Manchester Utd,eng Premier League,37,3099,34.4,35,2,0,18,12,30,9,9,10,1,MF,507c7bdf,Full Starter
75,Iago Aspas,18,2021-2022,33,es ESP,Celta Vigo,es La Liga,37,3087,34.3,36,1,0,18,5,23,15,3,5,2,FW,7dcf86f6,Full Starter
76,Callum Wilson,18,2022-2023,30,eng ENG,Newcastle Utd,eng Premier League,31,1877,20.9,21,10,1,18,5,23,15,3,3,0,FW,c596fcb0,Rotational Player
77,Andy Delort,18,2021-2022,29,dz ALG,2 Teams,fr Ligue 1,35,2717,30.2,29,6,0,18,3,21,15,3,3,0,FW,d33c706e,Rotational Player
78,Deniz Undav,18,2023-2024,27,de GER,Stuttgart,de Bundesliga,30,2089,23.2,23,7,0,18,10,28,18,0,1,1,FWMF,dd549382,Rotational Player
79,Cristiano Ronaldo,18,2021-2022,36,pt POR,2 Teams,2 Comps,31,2487,27.6,27,4,0,18,3,21,15,3,3,0,FW,dea698d9,Full Starter
80,Mohamed Salah,18,2023-2024,31,eg EGY,Liverpool,eng Premier League,32,2534,28.2,28,4,0,18,10,28,13,5,7,2,FW,e342ad68,Full Starter
81,Raúl de Tomás,17,2021-2022,26,es ESP,Espanyol,es La Liga,34,2914,32.4,33,1,0,17,3,20,12,5,5,0,FW,02ef8778,Rotational Player
82,Harry Kane,17,2021-2022,28,eng ENG,Tottenham,eng Premier League,37,3232,35.9,36,1,0,17,9,26,13,4,4,0,FW,21a66f6a,Full Starter
83,Harry Kane,17,2024-2025,31,eng ENG,Bayern Munich,de Bundesliga,17,1377,15.3,17,0,0,17,7,24,10,7,7,0,FW,21a66f6a,Full Starter
84,Giovanni Simeone,17,2021-2022,26,ar ARG,2 Teams,it Serie A,36,2660,29.6,32,4,1,17,5,22,17,0,1,1,FW,343c0d52,Rotational Player
85,Domenico Berardi,17,2020-2021,25,it ITA,Sassuolo,it Serie A,30,2475,27.5,28,2,0,17,7,24,10,7,8,1,FW,53a0e358,Rotational Player
86,Vinicius Júnior,17,2021-2022,21,br BRA,Real Madrid,es La Liga,35,2690,29.9,30,5,0,17,10,27,17,0,0,0,FW,7111d552,Rotational Player
87,Robert Lewandowski,17,2024-2025,35,pl POL,Barcelona,es La Liga,20,1587,17.6,19,1,1,17,2,19,15,2,3,1,FW,8d78e732,Full Starter
88,Alexander Isak,17,2020-2021,20,se SWE,Real Sociedad,es La Liga,34,2340,26.0,30,4,4,17,2,19,17,0,1,1,FW,8e92be30,Rotational Player
89,Alexander Isak,17,2024-2025,24,se SWE,Newcastle Utd,eng Premier League,21,1709,19.0,21,0,0,17,5,22,16,1,1,0,FW,8e92be30,Rotational Player
90,Ante Budimir,17,2023-2024,32,hr CRO,Osasuna,es La Liga,33,2435,27.1,29,4,1,17,2,19,14,3,4,1,FW,8f3565b3,Rotational Player
91,Son Heung-min,17,2020-2021,28,kr KOR,Tottenham,eng Premier League,37,3114,34.6,36,1,0,17,10,27,16,1,1,0,FW,92e7e919,Full Starter
92,Son Heung-min,17,2023-2024,31,kr KOR,Tottenham,eng Premier League,35,2934,32.6,34,1,0,17,10,27,15,2,2,0,FW,92e7e919,Full Starter
93,Patrick Bamford,17,2020-2021,26,eng ENG,Leeds United,eng Premier League,38,3050,33.9,37,1,0,17,7,24,15,2,2,0,FW,93feac6e,Full Starter
94,Marcus Rashford,17,2022-2023,24,eng ENG,Manchester Utd,eng Premier League,35,2879,32.0,32,3,0,17,5,22,17,0,0,0,FW,a1d5bd30,Rotational Player
95,Pierre-Emerick Aubameyang,17,2023-2024,34,ga GAB,Marseille,fr Ligue 1,34,2622,29.1,30,4,0,17,8,25,13,4,4,0,FW,d5dd5f1f,Full Starter
96,Tammy Abraham,17,2021-2022,23,eng ENG,2 Teams,2 Comps,37,3084,34.3,36,1,1,17,4,21,14,3,3,0,FW,f586779e,Rotational Player
97,Lautaro Martínez,17,2020-2021,22,ar ARG,Inter,it Serie A,38,2561,28.5,30,8,0,17,6,23,15,2,2,0,FW,f7036e1c,Full Starter
98,Youssef En-Nesyri,16,2023-2024,26,ma MAR,Sevilla,es La Liga,33,2570,28.6,28,5,0,16,2,18,15,1,1,0,FW,04e17fd5,Rotational Player
99,Sasa Kalajdzic,16,2020-2021,23,at AUT,Stuttgart,de Bundesliga,33,2136,23.7,23,10,1,16,5,21,16,0,0,0,FW,15f24fe7,Rotational Player
100,Burak Yılmaz,16,2020-2021,35,tr TUR,Lille,fr Ligue 1,28,2051,22.8,23,5,0,16,5,21,12,4,4,0,FW,165a2e40,Rotational Player
101,Boulaye Dia,16,2022-2023,25,sn SEN,Salernitana,it Serie A,33,2518,28.0,27,6,1,16,6,22,15,1,1,0,FWMF,244bc2c8,Rotational Player
102,Ludovic Ajorque,16,2020-2021,26,fr FRA,Strasbourg,fr Ligue 1,35,2967,33.0,34,1,1,16,4,20,12,4,5,1,FW,462475ed,Full Starter
103,Niclas Füllkrug,16,2022-2023,29,de GER,Werder Bremen,de Bundesliga,28,2477,27.5,28,0,1,16,5,21,11,5,5,0,FW,4f16405e,Rotational Player
104,Jean-Philippe Mateta,16,2023-2024,26,fr FRA,Crystal Palace,eng Premier League,35,2282,25.4,25,10,2,16,5,21,14,2,2,0,FW,50e6dc35,Rotational Player
105,Dominic Calvert-Lewin,16,2020-2021,23,eng ENG,Everton,eng Premier League,33,2871,31.9,32,1,0,16,0,16,16,0,0,0,FW,59e6e5bf,Rotational Player
106,Maximilian Beier,16,2023-2024,20,de GER,Hoffenheim,de Bundesliga,33,2420,26.9,29,4,0,16,1,17,16,0,0,0,FWMF,5db45ee5,Rotational Player
107,Joselu,16,2022-2023,32,es ESP,Espanyol,es La Liga,34,2990,33.2,33,1,1,16,2,18,11,5,5,0,FW,6265208f,Full Starter
108,Kevin Volland,16,2020-2021,28,de GER,Monaco,fr Ligue 1,35,2769,30.8,34,1,0,16,7,23,16,0,0,0,FWMF,64f69877,Rotational Player
109,Dušan Vlahović,16,2023-2024,23,rs SRB,Juventus,it Serie A,33,2307,25.6,27,6,0,16,4,20,14,2,4,2,FW,79443529,Full Starter
110,Jarrod Bowen,16,2023-2024,26,eng ENG,West Ham,eng Premier League,34,3019,33.5,34,0,0,16,6,22,16,0,0,0,FW,79c84d1c,Full Starter
111,Christopher Nkunku,16,2022-2023,24,fr FRA,RB Leipzig,de Bundesliga,25,1897,21.1,20,5,0,16,4,20,13,3,4,1,FWMF,7c56da38,Rotational Player
112,Gaëtan Laborde,16,2020-2021,26,fr FRA,Montpellier,fr Ligue 1,38,3256,36.2,38,0,0,16,8,24,16,0,0,0,FWMF,7cdda3bf,Full Starter
113,João Pedro,16,2020-2021,28,it ITA,Cagliari,it Serie A,37,3253,36.1,37,0,1,16,3,19,12,4,5,1,FWMF,81255c03,Rotational Player
114,Juanmi,16,2021-2022,28,es ESP,Betis,es La Liga,33,2131,23.7,26,7,3,16,4,20,16,0,0,0,FW,84399660,Rotational Player
115,Gianluca Scamacca,16,2021-2022,22,it ITA,Sassuolo,it Serie A,36,2146,23.8,25,11,0,16,0,16,15,1,1,0,FW,8790f988,Rotational Player
116,Wissam Ben Yedder,16,2023-2024,32,fr FRA,Monaco,fr Ligue 1,32,2316,25.7,26,6,1,16,2,18,15,1,1,0,FW,942b4f90,Full Starter
117,Bukayo Saka,16,2023-2024,21,eng ENG,Arsenal,eng Premier League,35,2919,32.4,35,0,0,16,9,25,10,6,6,0,FW,bc7dc64d,Full Starter
118,Sadio Mané,16,2021-2022,29,sn SEN,Liverpool,eng Premier League,34,2819,31.3,32,2,0,16,2,18,16,0,0,0,FW,c691bfe2,Full Starter
119,Lionel Messi,16,2022-2023,35,ar ARG,Paris S-G,fr Ligue 1,32,2837,31.5,32,0,0,16,16,32,16,0,0,0,FWMF,d70ce98e,Full Starter
120,Antoine Griezmann,16,2023-2024,32,fr FRA,Atlético Madrid,es La Liga,33,2644,29.4,31,2,1,16,6,22,12,4,4,0,FWMF,df69b544,Full Starter
121,Mateo Retegui,16,2024-2025,25,it ITA,Atalanta,it Serie A,20,1142,12.7,16,4,0,16,3,19,14,2,2,0,FW,e7695e6c,Rotational Player
122,Enes Ünal,16,2021-2022,24,tr TUR,Getafe,es La Liga,37,2798,31.1,33,4,0,16,1,17,14,2,4,2,FW,f8eca1b6,Full Starter
123,Vedat Muriqi,15,2022-2023,28,xk KVX,Mallorca,es La Liga,35,2937,32.6,34,1,0,15,3,18,11,4,5,1,FW,0cadc46d,Rotational Player
124,Omar Marmoush,15,2024-2025,25,eg EGY,2 Teams,2 Comps,18,1521,16.9,18,0,0,15,9,24,13,2,2,0,FW,0e0102eb,Rotational Player
125,Álvaro Morata,15,2023-2024,30,es ESP,Atlético Madrid,es La Liga,32,1904,21.2,21,11,2,15,3,18,15,0,1,1,FW,129af0db,Rotational Player
126,Olivier Giroud,15,2023-2024,36,fr FRA,Milan,it Serie A,35,2363,26.3,28,7,1,15,8,23,11,4,5,1,FW,16ceb862,Rotational Player
127,Diogo Jota,15,2021-2022,24,pt POR,Liverpool,eng Premier League,35,2364,26.3,27,8,1,15,4,19,15,0,0,0,FW,178ae8f8,Rotational Player
128,Rafael Leão,15,2022-2023,23,pt POR,Milan,it Serie A,35,2421,26.9,28,7,0,15,8,23,15,0,0,0,FWMF,20730eae,Full Starter
129,Kylian Mbappé,15,2024-2025,25,fr FRA,Real Madrid,es La Liga,19,1638,18.2,19,0,0,15,2,17,10,5,6,1,FW,42fd9c7f,Full Starter
130,Jamie Vardy,15,2021-2022,34,eng ENG,Leicester City,eng Premier League,25,1806,20.1,20,5,2,15,2,17,15,0,0,0,FW,45963054,Rotational Player
131,Jamie Vardy,15,2020-2021,33,eng ENG,Leicester City,eng Premier League,34,2840,31.6,31,3,0,15,9,24,7,8,9,1,FW,45963054,Rotational Player
132,Gabriel Martinelli,15,2022-2023,21,br BRA,Arsenal,eng Premier League,36,2789,31.0,34,2,0,15,5,20,15,0,0,0,FW,48a5a5d6,Rotational Player
133,Zlatan Ibrahimović,15,2020-2021,38,se SWE,Milan,it Serie A,19,1493,16.6,18,1,0,15,2,17,12,3,6,3,FW,4cde5509,Rotational Player
134,Domenico Berardi,15,2021-2022,26,it ITA,Sassuolo,it Serie A,33,2819,31.3,33,0,0,15,14,29,9,6,6,0,FW,53a0e358,Rotational Player
135,Vincenzo Grifo,15,2022-2023,29,it ITA,Freiburg,de Bundesliga,33,2408,26.8,30,3,0,15,5,20,8,7,8,1,MFFW,54e4866f,Full Starter
136,Andrej Kramarić,15,2023-2024,32,hr CRO,Hoffenheim,de Bundesliga,30,2199,24.4,25,5,1,15,6,21,10,5,5,0,MFFW,603cb947,Rotational Player
137,Borja Mayoral,15,2023-2024,26,es ESP,Getafe,es La Liga,27,2153,23.9,25,2,0,15,1,16,11,4,4,0,FW,64e8ed6d,Rotational Player
138,Vinicius Júnior,15,2023-2024,23,br BRA,Real Madrid,es La Liga,26,1864,20.7,22,4,3,15,5,20,14,1,1,0,FW,7111d552,Rotational Player
139,Borja Iglesias,15,2022-2023,29,es ESP,Betis,es La Liga,35,2365,26.3,29,6,0,15,3,18,10,5,6,1,FW,75645f0e,Rotational Player
140,Martin Ødegaard,15,2022-2023,23,no NOR,Arsenal,eng Premier League,37,3127,34.7,37,0,0,15,7,22,15,0,0,0,MF,79300479,Full Starter
141,Gaëtan Laborde,15,2022-2023,28,fr FRA,2 Teams,fr Ligue 1,37,2755,30.6,31,6,0,15,3,18,15,0,1,1,FW,7cdda3bf,Full Starter
142,Gaëtan Laborde,15,2021-2022,27,fr FRA,2 Teams,fr Ligue 1,38,3070,34.1,36,2,0,15,8,23,13,2,2,0,FW,7cdda3bf,Full Starter
143,Victor Osimhen,15,2023-2024,24,ng NGA,Napoli,it Serie A,25,1982,22.0,22,3,1,15,3,18,12,3,5,2,FW,8c90fd7a,Rotational Player
144,Amine Gouiri,15,2022-2023,22,dz ALG,2 Teams,fr Ligue 1,36,2749,30.5,32,4,1,15,3,18,15,0,0,0,FWMF,aad56ca3,Full Starter
145,Ollie Watkins,15,2022-2023,26,eng ENG,Aston Villa,eng Premier League,37,3127,34.7,36,1,0,15,6,21,14,1,2,1,FW,aed3a70f,Full Starter
146,Randal Kolo Muani,15,2022-2023,23,fr FRA,Eint Frankfurt,de Bundesliga,32,2631,29.2,31,1,0,15,11,26,13,2,2,0,FW,c0b3669f,Rotational Player
147,Jonathan David,15,2021-2022,21,ca CAN,Lille,fr Ligue 1,38,2804,31.2,32,6,0,15,0,15,13,2,3,1,FW,ce50fd99,Full Starter
148,Andy Delort,15,2020-2021,28,dz ALG,Montpellier,fr Ligue 1,30,2482,27.6,30,0,0,15,9,24,15,0,1,1,FW,d33c706e,Rotational Player
149,Duván Zapata,15,2020-2021,29,co COL,Atalanta,it Serie A,37,2379,26.4,29,8,0,15,9,24,14,1,1,0,FW,d3de9af0,Rotational Player
150,Pierre-Emerick Aubameyang,15,2021-2022,32,ga GAB,2 Teams,2 Comps,31,2119,23.5,25,6,0,15,2,17,15,0,2,2,FW,d5dd5f1f,Full Starter
151,Antoine Griezmann,15,2022-2023,31,fr FRA,Atlético Madrid,es La Liga,38,2859,31.8,31,7,0,15,16,31,15,0,0,0,FWMF,df69b544,Full Starter
152,Kevin De Bruyne,15,2021-2022,30,be BEL,Manchester City,eng Premier League,30,2201,24.5,25,5,3,15,8,23,15,0,0,0,MF,e46012d4,Rotational Player
153,Taiwo Awoniyi,15,2021-2022,23,ng NGA,Union Berlin,de Bundesliga,31,2174,24.2,29,2,0,15,1,16,13,2,2,0,FW,e5478b87,Rotational Player
154,Ermedin Demirović,15,2023-2024,25,ba BIH,Augsburg,de Bundesliga,33,2873,31.9,33,0,0,15,9,24,12,3,4,1,FWMF,ed79b7d3,Rotational Player
155,Marko Arnautović,14,2021-2022,32,at AUT,Bologna,it Serie A,33,2694,29.9,32,1,1,14,1,15,12,2,3,1,FW,00459419,Rotational Player
156,Mohamed Lamine Bayo,14,2021-2022,23,gn GUI,Clermont Foot,fr Ligue 1,32,2413,26.8,27,5,0,14,5,19,12,2,3,1,FW,01870104,Rotational Player
157,Terem Moffi,14,2020-2021,21,ng NGA,Lorient,fr Ligue 1,32,2073,23.0,26,6,0,14,2,16,13,1,1,0,FW,065dc209,Full Starter
158,Boulaye Dia,14,2020-2021,23,sn SEN,Reims,fr Ligue 1,36,2930,32.6,35,1,1,14,1,15,9,5,5,0,FWMF,244bc2c8,Rotational Player
159,Alexis Sánchez,14,2022-2023,33,cl CHI,Marseille,fr Ligue 1,35,2679,29.8,32,3,2,14,3,17,12,2,3,1,FWMF,2c0f8e9e,Rotational Player
160,Benjamin Šeško,14,2023-2024,20,si SVN,RB Leipzig,de Bundesliga,31,1526,17.0,17,14,2,14,2,16,14,0,0,0,FW,3260690c,Rotational Player
161,Aleksandar Mitrović,14,2022-2023,27,rs SRB,Fulham,eng Premier League,24,2008,22.3,23,1,0,14,1,15,10,4,8,4,FW,3925dbd6,Rotational Player
162,Chris Wood,14,2023-2024,31,nz NZL,Nott'ham Forest,eng Premier League,31,1812,20.1,20,11,0,14,1,15,14,0,0,0,FW,4e9a0555,Rotational Player
163,Chris Wood,14,2024-2025,32,nz NZL,Nott'ham Forest,eng Premier League,23,1834,20.4,22,1,0,14,2,16,12,2,2,0,FW,4e9a0555,Rotational Player
164,Karl Toko Ekambi,14,2020-2021,27,cm CMR,Lyon,fr Ligue 1,35,2811,31.2,34,1,0,14,6,20,14,0,0,0,FW,5ceba7fc,Full Starter
165,Joselu,14,2021-2022,31,es ESP,Alavés,es La Liga,37,3122,34.7,35,2,0,14,4,18,8,6,7,1,FW,6265208f,Full Starter
166,Bryan Mbeumo,14,2024-2025,24,cm CMR,Brentford,eng Premier League,23,2064,22.9,23,0,0,14,3,17,10,4,4,0,FW,6afaebf2,Full Starter
167,Gorka Guruzeta,14,2023-2024,26,es ESP,Athletic Club,es La Liga,32,2217,24.6,30,2,1,14,5,19,14,0,1,1,FW,6b5ea2f4,Rotational Player
168,Lars Stindl,14,2020-2021,31,de GER,Gladbach,de Bundesliga,30,1961,21.8,23,7,0,14,8,22,8,6,7,1,MFFW,7cd6badb,Rotational Player
169,Iago Aspas,14,2020-2021,32,es ESP,Celta Vigo,es La Liga,33,2864,31.8,33,0,1,14,13,27,9,5,5,0,FW,7dcf86f6,Full Starter
170,Serge Gnabry,14,2021-2022,26,de GER,Bayern Munich,de Bundesliga,34,2185,24.3,25,9,0,14,5,19,14,0,0,0,FWDF,88e357ef,Rotational Player
171,Serge Gnabry,14,2022-2023,27,de GER,Bayern Munich,de Bundesliga,34,1941,21.6,22,12,0,14,5,19,13,1,1,0,FWMF,88e357ef,Rotational Player
172,Victor Osimhen,14,2021-2022,22,ng NGA,Napoli,it Serie A,27,1983,22.0,23,4,0,14,2,16,14,0,0,0,FW,8c90fd7a,Rotational Player
173,Nicolas Jackson,14,2023-2024,22,sn SEN,Chelsea,eng Premier League,35,2799,31.1,31,4,0,14,5,19,14,0,0,0,FW,9c36ed83,Rotational Player
174,Ollie Watkins,14,2020-2021,24,eng ENG,Aston Villa,eng Premier League,37,3328,37.0,37,0,0,14,5,19,13,1,2,1,FW,aed3a70f,Full Starter
175,Victor Boniface,14,2023-2024,22,ng NGA,Leverkusen,de Bundesliga,23,1546,17.2,18,5,0,14,8,22,10,4,4,0,FW,b146275b,Rotational Player
176,Wilfried Zaha,14,2021-2022,28,ci CIV,Crystal Palace,eng Premier League,33,2760,30.7,31,2,0,14,1,15,9,5,7,2,FW,b2bc3b1f,Full Starter
177,Thijs Dallinga,14,2023-2024,22,nl NED,Toulouse,fr Ligue 1,33,2510,27.9,28,5,0,14,2,16,13,1,3,2,FW,b70afb45,Full Starter
178,Albert Guðmundsson,14,2023-2024,26,is ISL,Genoa,it Serie A,35,3016,33.5,34,1,0,14,4,18,10,4,5,1,FWMF,b79858d5,Rotational Player
179,Bukayo Saka,14,2022-2023,20,eng ENG,Arsenal,eng Premier League,38,3181,35.3,37,1,0,14,11,25,12,2,3,1,FW,bc7dc64d,Full Starter
180,Cole Palmer,14,2024-2025,22,eng ENG,Chelsea,eng Premier League,23,2010,22.3,23,0,0,14,6,20,11,3,3,0,MF,dc7f8a28,Full Starter
181,Enes Ünal,14,2022-2023,25,tr TUR,Getafe,es La Liga,35,2970,33.0,35,0,0,14,3,17,9,5,6,1,FW,f8eca1b6,Full Starter
182,Franck Kessié,13,2020-2021,23,ci CIV,Milan,it Serie A,37,3226,35.8,36,1,0,13,4,17,2,11,13,2,MF,05e19d6a,Full Starter
183,Andrea Pinamonti,13,2021-2022,22,it ITA,2 Teams,it Serie A,36,2869,31.9,32,4,1,13,2,15,9,4,4,0,FW,08aa9cd1,Full Starter
184,Donyell Malen,13,2023-2024,24,nl NED,Dortmund,de Bundesliga,27,1781,19.8,21,6,2,13,1,14,13,0,0,0,FWMF,116c35df,Rotational Player
185,Álvaro Morata,13,2022-2023,29,es ESP,Atlético Madrid,es La Liga,36,1900,21.1,23,13,1,13,2,15,13,0,0,0,FW,129af0db,Rotational Player
186,Olivier Giroud,13,2022-2023,35,fr FRA,Milan,it Serie A,33,2139,23.8,25,8,2,13,5,18,10,3,3,0,FW,16ceb862,Rotational Player
187,Rodrigo,13,2022-2023,31,es ESP,Leeds United,eng Premier League,31,1935,21.5,23,8,0,13,1,14,12,1,1,0,FWMF,1fb1c435,Rotational Player
188,Hugo Duro,13,2023-2024,23,es ESP,Valencia,es La Liga,37,2976,33.1,35,2,0,13,2,15,13,0,0,0,FW,37e103f8,Rotational Player
189,Gerard Deulofeu,13,2021-2022,27,es ESP,Udinese,it Serie A,34,2616,29.1,31,3,0,13,5,18,12,1,1,0,FWMF,39583cfd,Full Starter
190,Edin Džeko,13,2021-2022,35,ba BIH,Inter,it Serie A,36,2469,27.4,27,9,2,13,6,19,13,0,0,0,FW,3bb7f478,Rotational Player
191,Moise Kean,13,2020-2021,20,it ITA,2 Teams,2 Comps,28,1713,19.0,22,6,5,13,0,13,13,0,0,0,FWMF,3d50bcdb,Rotational Player
192,Harvey Barnes,13,2022-2023,24,eng ENG,Leicester City,eng Premier League,34,2711,30.1,32,2,0,13,1,14,13,0,0,0,FWMF,3ea50f67,Rotational Player
193,Georges Mikautadze,13,2023-2024,22,ge GEO,Metz,fr Ligue 1,20,1747,19.4,20,0,0,13,4,17,10,3,3,0,FW,4788cb6b,Rotational Player
194,José Luis Morales,13,2021-2022,34,es ESP,Levante,es La Liga,35,2719,30.2,31,4,0,13,7,20,10,3,5,2,FWMF,4a478107,Rotational Player
195,José Luis Morales,13,2020-2021,33,es ESP,Levante,es La Liga,38,2439,27.1,30,8,0,13,3,16,13,0,1,1,MFFW,4a478107,Rotational Player
196,Patrik Schick,13,2024-2025,28,cz CZE,Leverkusen,de Bundesliga,16,781,8.7,9,7,2,13,0,13,13,0,0,0,FW,5d4f7d61,Rotational Player
197,Romelu Lukaku,13,2023-2024,30,be BEL,Roma,it Serie A,32,2641,29.3,30,2,0,13,3,16,13,0,1,1,FW,5eae500a,Rotational Player
198,Neymar,13,2021-2022,29,br BRA,Paris S-G,fr Ligue 1,22,1851,20.6,22,0,0,13,6,19,10,3,4,1,FWMF,69384e5d,Rotational Player
199,Neymar,13,2022-2023,30,br BRA,Paris S-G,fr Ligue 1,20,1545,17.2,18,2,0,13,11,24,11,2,2,0,MFFW,69384e5d,Rotational Player
200,Marcus Thuram,13,2023-2024,25,fr FRA,Inter,it Serie A,35,2687,29.9,34,1,1,13,7,20,13,0,0,0,FW,6f8cd6d0,Rotational Player
201,Marcus Thuram,13,2023-2024,25,fr FRA,Inter,it Serie A,35,2687,29.9,34,1,1,13,7,20,13,0,0,0,FW,6f8cd6d0,Rotational Player
202,Marcus Thuram,13,2024-2025,26,fr FRA,Inter,it Serie A,21,1586,17.6,19,2,0,13,4,17,13,0,0,0,FW,6f8cd6d0,Rotational Player
203,Ademola Lookman,13,2022-2023,24,ng NGA,Atalanta,it Serie A,31,1729,19.2,20,11,1,13,6,19,10,3,3,0,FWMF,7c104bb7,Rotational Player
204,João Pedro,13,2021-2022,29,it ITA,Cagliari,it Serie A,37,3323,36.9,37,0,0,13,4,17,10,3,4,1,FW,81255c03,Rotational Player
205,İlkay Gündoğan,13,2020-2021,29,de GER,Manchester City,eng Premier League,28,2029,22.5,23,5,6,13,2,15,12,1,2,1,MF,819b3158,Full Starter
206,Alexandre Lacazette,13,2020-2021,29,fr FRA,Arsenal,eng Premier League,31,1923,21.4,22,9,5,13,2,15,10,3,3,0,FW,9dbb75ca,Rotational Player
207,M'Bala Nzola,13,2022-2023,25,ao ANG,Spezia,it Serie A,31,2653,29.5,29,2,0,13,2,15,10,3,3,0,FW,a4948e67,Rotational Player
208,Moussa Diaby,13,2021-2022,22,fr FRA,Leverkusen,de Bundesliga,32,2760,30.7,32,0,0,13,12,25,13,0,1,1,FWMF,aeed5c06,Full Starter
209,Raheem Sterling,13,2021-2022,26,eng ENG,Manchester City,eng Premier League,30,2128,23.6,23,7,7,13,5,18,11,2,3,1,FW,b400bde0,Rotational Player
210,Rafa Mir,13,2020-2021,23,es ESP,Huesca,es La Liga,38,2877,32.0,32,6,0,13,1,14,11,2,3,1,FW,bbf5c11b,Rotational Player
211,Hakan Çalhanoğlu,13,2023-2024,29,tr TUR,Inter,it Serie A,32,2556,28.4,32,0,3,13,3,16,3,10,10,0,MF,cd0fa27b,Full Starter
212,Jonathan David,13,2020-2021,20,ca CAN,Lille,fr Ligue 1,37,2354,26.2,29,8,0,13,2,15,13,0,0,0,FW,ce50fd99,Full Starter
213,Duván Zapata,13,2023-2024,32,co COL,2 Teams,it Serie A,37,2992,33.2,36,1,0,13,4,17,13,0,0,0,FW,d3de9af0,Rotational Player
214,Andrea Belotti,13,2020-2021,26,it ITA,Torino,it Serie A,35,2888,32.1,33,2,2,13,6,19,9,4,5,1,FW,d705ba44,Rotational Player
215,Valentín Castellanos,13,2022-2023,23,ar ARG,Girona,es La Liga,35,2597,28.9,33,2,0,13,0,13,12,1,1,0,FW,da76bab4,Rotational Player
216,Henrikh Mkhitaryan,13,2020-2021,31,am ARM,Roma,it Serie A,34,2745,30.5,30,4,0,13,10,23,12,1,1,0,MFFW,dd0daf32,Full Starter
217,Antoine Griezmann,13,2020-2021,29,fr FRA,Barcelona,es La Liga,36,2604,28.9,32,4,2,13,7,20,12,1,2,1,FWMF,df69b544,Full Starter
218,Paulo Dybala,13,2023-2024,29,ar ARG,Roma,it Serie A,28,1959,21.8,25,3,1,13,9,22,6,7,7,0,FWMF,e0921a4f,Rotational Player
219,Mario Pašalić,13,2021-2022,26,hr CRO,Atalanta,it Serie A,37,2002,22.2,24,13,0,13,6,19,13,0,0,0,MFFW,e599253a,Rotational Player
220,Fabio Quagliarella,13,2020-2021,37,it ITA,Sampdoria,it Serie A,33,2204,24.5,25,8,4,13,1,14,11,2,3,1,FW,ee4f2f3b,Rotational Player
221,Jørgen Strand Larsen,13,2023-2024,23,no NOR,Celta Vigo,es La Liga,37,2863,31.8,36,1,0,13,3,16,13,0,0,0,FW,f553b2b3,Full Starter
222,Kai Havertz,13,2023-2024,24,de GER,Arsenal,eng Premier League,37,2634,29.3,30,7,0,13,7,20,12,1,1,0,MFFW,fed7cb61,Rotational Player
223,Ángel Correa,12,2021-2022,26,ar ARG,Atlético Madrid,es La Liga,36,1856,20.6,21,15,0,12,5,17,12,0,0,0,FWMF,01eb744d,Rotational Player
224,Marcos Llorente,12,2020-2021,25,es ESP,Atlético Madrid,es La Liga,37,2956,32.8,33,4,0,12,11,23,12,0,0,0,MFFW,02c15616,Rotational Player
225,Jonathan Burkardt,12,2024-2025,24,de GER,Mainz 05,de Bundesliga,16,1123,12.5,16,0,0,12,1,13,11,1,1,0,FW,05f99a4a,Rotational Player
226,Danny Ings,12,2020-2021,28,eng ENG,Southampton,eng Premier League,29,2173,24.1,26,3,0,12,4,16,10,2,2,0,FW,07802f7f,Rotational Player
227,Antonio Sanabria,12,2022-2023,26,py PAR,Torino,it Serie A,33,2433,27.0,28,5,2,12,4,16,11,1,1,0,FW,0a447501,Rotational Player
228,Roger Martí,12,2020-2021,29,es ESP,Levante,es La Liga,33,2198,24.4,26,7,3,12,4,16,10,2,4,2,FW,0ae4e09a,Rotational Player
229,Breel Embolo,12,2022-2023,25,ch SUI,Monaco,fr Ligue 1,32,1859,20.7,19,13,0,12,2,14,12,0,1,1,FW,0b4f388a,Rotational Player
230,Santi Mina,12,2020-2021,24,es ESP,Celta Vigo,es La Liga,34,2412,26.8,29,5,1,12,3,15,11,1,1,0,FW,0b90bb97,Full Starter
231,Omar Marmoush,12,2023-2024,24,eg EGY,Eint Frankfurt,de Bundesliga,29,2301,25.6,27,2,0,12,6,18,10,2,2,0,FWMF,0e0102eb,Rotational Player
232,Hwang Hee-chan,12,2023-2024,27,kr KOR,Wolves,eng Premier League,29,2119,23.5,25,4,0,12,3,15,11,1,1,0,FWMF,169fd162,Rotational Player
233,Christian Pulisic,12,2023-2024,24,us USA,Milan,it Serie A,36,2602,28.9,32,4,0,12,8,20,12,0,0,0,FWMF,1bf33a9a,Rotational Player
234,Nicolás González,12,2023-2024,25,ar ARG,Fiorentina,it Serie A,29,1913,21.3,21,8,1,12,2,14,11,1,3,2,FW,2374aaca,Rotational Player
235,Yoane Wissa,12,2023-2024,26,cd COD,Brentford,eng Premier League,34,2493,27.7,29,5,0,12,3,15,12,0,0,0,FW,2500cef9,Rotational Player
236,Tim Kleindienst,12,2023-2024,27,de GER,Heidenheim,de Bundesliga,33,2869,31.9,33,0,0,12,3,15,10,2,2,0,FW,258a6f4d,Full Starter
237,Jonas Hofmann,12,2022-2023,30,de GER,Gladbach,de Bundesliga,31,2680,29.8,30,1,0,12,9,21,12,0,1,1,FWMF,2903a856,Full Starter
238,Jonas Hofmann,12,2021-2022,29,de GER,Gladbach,de Bundesliga,26,2078,23.1,24,2,0,12,5,17,12,0,0,0,MFFW,2903a856,Full Starter
239,Jamal Musiala,12,2022-2023,19,de GER,Bayern Munich,de Bundesliga,33,2198,24.4,26,7,0,12,10,22,12,0,0,0,MFFW,2c0558b8,Rotational Player
240,Raphinha,12,2024-2025,27,br BRA,Barcelona,es La Liga,21,1735,19.3,20,1,0,12,6,18,11,1,1,0,FWMF,3423f250,Full Starter
241,Leandro Trossard,12,2023-2024,28,be BEL,Arsenal,eng Premier League,34,1649,18.3,18,16,3,12,1,13,12,0,0,0,FWMF,38ceb24a,Rotational Player
242,Moise Kean,12,2024-2025,24,it ITA,Fiorentina,it Serie A,20,1666,18.5,19,1,0,12,2,14,11,1,2,1,FW,3d50bcdb,Rotational Player
243,Ciro Immobile,12,2022-2023,32,it ITA,Lazio,it Serie A,31,2219,24.7,27,4,2,12,5,17,8,4,5,1,FW,4431aed2,Full Starter
244,Ludovic Ajorque,12,2021-2022,27,fr FRA,Strasbourg,fr Ligue 1,36,2738,30.4,31,5,0,12,8,20,9,3,3,0,FW,462475ed,Full Starter
245,Chris Wood,12,2020-2021,28,nz NZL,Burnley,eng Premier League,33,2741,30.5,32,1,0,12,3,15,10,2,2,0,FW,4e9a0555,Rotational Player
246,Niclas Füllkrug,12,2023-2024,30,de GER,2 Teams,de Bundesliga,31,2392,26.6,29,2,2,12,8,20,9,3,3,0,FW,4f16405e,Rotational Player
247,Domenico Berardi,12,2022-2023,27,it ITA,Sassuolo,it Serie A,26,1866,20.7,22,4,1,12,7,19,5,7,8,1,FW,53a0e358,Rotational Player
248,Gianluca Caprari,12,2021-2022,28,it ITA,Hellas Verona,it Serie A,35,2739,30.4,33,2,0,12,7,19,10,2,2,0,MFFW,54e53b7e,Full Starter
249,Dimitri Payet,12,2021-2022,34,fr FRA,Marseille,fr Ligue 1,31,2592,28.8,28,3,0,12,10,22,5,7,7,0,FWMF,58ae47b2,Rotational Player
250,Mason Greenwood,12,2024-2025,22,eng ENG,Marseille,fr Ligue 1,19,1631,18.1,19,0,0,12,3,15,8,4,5,1,FWMF,58eee997,Rotational Player
251,Karl Toko Ekambi,12,2021-2022,28,cm CMR,Lyon,fr Ligue 1,30,2296,25.5,26,4,0,12,5,17,10,2,2,0,FW,5ceba7fc,Full Starter
252,Andrej Kramarić,12,2022-2023,31,hr CRO,Hoffenheim,de Bundesliga,32,2386,26.5,26,6,1,12,4,16,8,4,6,2,MFFW,603cb947,Rotational Player
253,Marvin Ducksch,12,2023-2024,29,de GER,Werder Bremen,de Bundesliga,33,2696,30.0,32,1,0,12,9,21,7,5,6,1,FW,638a4d71,Full Starter
254,Marvin Ducksch,12,2022-2023,28,de GER,Werder Bremen,de Bundesliga,34,2852,31.7,34,0,0,12,6,18,12,0,1,1,FW,638a4d71,Full Starter
255,Iñaki Williams,12,2023-2024,29,gh GHA,Athletic Club,es La Liga,34,2844,31.6,32,2,0,12,3,15,12,0,0,0,FW,6a99e0b1,Full Starter
256,Téji Savanier,12,2022-2023,30,fr FRA,Montpellier,fr Ligue 1,30,2546,28.3,30,0,0,12,4,16,6,6,6,0,MF,6bde367b,Full Starter
257,Jarrod Bowen,12,2021-2022,24,eng ENG,West Ham,eng Premier League,36,2983,33.1,34,2,0,12,10,22,12,0,0,0,FW,79c84d1c,Full Starter
258,Iago Aspas,12,2022-2023,34,es ESP,Celta Vigo,es La Liga,37,2868,31.9,31,6,0,12,3,15,10,2,3,1,FW,7dcf86f6,Full Starter
259,Gianluca Scamacca,12,2023-2024,24,it ITA,Atalanta,it Serie A,29,1453,16.1,17,12,3,12,6,18,12,0,0,0,FW,8790f988,Rotational Player
260,Memphis,12,2021-2022,27,nl NED,Barcelona,es La Liga,28,1851,20.6,20,8,1,12,2,14,8,4,5,1,FW,8f696594,Rotational Player
261,Nicolas Jackson,12,2022-2023,21,sn SEN,Villarreal,es La Liga,26,1598,17.8,16,10,3,12,4,16,12,0,0,0,FW,9c36ed83,Rotational Player
262,Teun Koopmeiners,12,2023-2024,25,nl NED,Atalanta,it Serie A,34,2627,29.2,29,5,0,12,5,17,10,2,2,0,MF,a26fb8aa,Full Starter
263,Hwang Ui-jo,12,2020-2021,27,kr KOR,Bordeaux,fr Ligue 1,36,2503,27.8,32,4,1,12,3,15,9,3,3,0,FWMF,a2d873dd,Full Starter
264,Amine Gouiri,12,2020-2021,20,dz ALG,Nice,fr Ligue 1,34,2747,30.5,31,3,0,12,7,19,8,4,4,0,FWMF,aad56ca3,Full Starter
265,Thijs Dallinga,12,2022-2023,21,nl NED,Toulouse,fr Ligue 1,36,2353,26.1,28,8,1,12,1,13,12,0,0,0,FW,b70afb45,Full Starter
266,Arnaud Kalimuendo,12,2021-2022,19,fr FRA,2 Teams,fr Ligue 1,34,2156,24.0,27,7,2,12,0,12,10,2,2,0,FW,bf4c41f9,Rotational Player
267,Randal Kolo Muani,12,2021-2022,22,fr FRA,Nantes,fr Ligue 1,36,2948,32.8,34,2,1,12,4,16,12,0,0,0,FWMF,c0b3669f,Rotational Player
268,Callum Wilson,12,2020-2021,28,eng ENG,Newcastle Utd,eng Premier League,26,2084,23.2,23,3,1,12,5,17,8,4,4,0,FW,c596fcb0,Rotational Player
269,Kelechi Iheanacho,12,2020-2021,23,ng NGA,Leicester City,eng Premier League,25,1459,16.2,16,9,13,12,2,14,12,0,1,1,FW,c92e1a31,Rotational Player
270,Matheus Cunha,12,2023-2024,24,br BRA,Wolves,eng Premier League,32,2440,27.1,29,3,0,12,7,19,11,1,1,0,FWMF,dc62b55d,Rotational Player
271,Khvicha Kvaratskhelia,12,2022-2023,21,ge GEO,Napoli,it Serie A,34,2518,28.0,30,4,0,12,10,22,10,2,2,0,FW,dea88efd,Full Starter
272,Paulo Dybala,12,2022-2023,28,ar ARG,Roma,it Serie A,25,1739,19.3,21,4,1,12,6,18,7,5,5,0,MFFW,e0921a4f,Rotational Player
273,Ivan Toney,12,2021-2022,25,eng ENG,Brentford,eng Premier League,33,2909,32.3,32,1,0,12,5,17,7,5,5,0,FW,e09f279b,Full Starter
274,Kiké,12,2020-2021,30,es ESP,Eibar,es La Liga,37,3087,34.3,36,1,0,12,2,14,12,0,0,0,FW,e897d8ba,Rotational Player
275,Alexander Sørloth,12,2022-2023,26,no NOR,2 Teams,2 Comps,35,2392,26.6,28,7,1,12,3,15,12,0,0,0,FW,e92cd3f7,Rotational Player
276,James Maddison,12,2021-2022,24,eng ENG,Leicester City,eng Premier League,35,2459,27.3,28,7,0,12,8,20,12,0,0,0,MFFW,ee38d9c5,Rotational Player
277,Max Kruse,12,2021-2022,33,de GER,2 Teams,de Bundesliga,30,2398,26.6,30,0,2,12,5,17,7,5,5,0,MFFW,f9446dcd,Rotational Player
278,Mama Samba Baldé,12,2022-2023,26,gw GNB,Troyes,fr Ligue 1,34,2665,29.6,30,4,0,12,3,15,10,2,2,0,FW,fb14aa28,Rotational Player
279,Myrto Uzuni,11,2023-2024,28,al ALB,Granada,es La Liga,34,2448,27.2,28,6,1,11,1,12,7,4,5,1,FW,01da7812,Full Starter
280,Antonín Barák,11,2021-2022,26,cz CZE,Hellas Verona,it Serie A,29,2340,26.0,27,2,1,11,4,15,7,4,4,0,MFFW,01efac19,Rotational Player
281,Joshua Zirkzee,11,2023-2024,22,nl NED,Bologna,it Serie A,34,2759,30.7,32,2,0,11,4,15,9,2,2,0,FW,028e70b9,Rotational Player
282,Jonathan Burkardt,11,2021-2022,21,de GER,Mainz 05,de Bundesliga,34,2611,29.0,32,2,0,11,3,14,10,1,1,0,FWMF,05f99a4a,Rotational Player
283,Terem Moffi,11,2023-2024,24,ng NGA,Nice,fr Ligue 1,30,1949,21.7,23,7,0,11,2,13,8,3,3,0,FW,065dc209,Full Starter
284,Teemu Pukki,11,2021-2022,31,fi FIN,Norwich City,eng Premier League,37,3253,36.1,37,0,0,11,3,14,8,3,3,0,FW,0745b37d,Full Starter
285,Andrea Pinamonti,11,2023-2024,24,it ITA,Sassuolo,it Serie A,38,3076,34.2,37,1,0,11,1,12,9,2,3,1,FW,08aa9cd1,Full Starter
286,Dodi Lukebakio,11,2022-2023,24,be BEL,Hertha BSC,de Bundesliga,32,2397,26.6,27,5,0,11,3,14,6,5,5,0,FWMF,0c61c77c,Rotational Player
287,Álvaro Morata,11,2020-2021,27,es ESP,Juventus,it Serie A,32,2014,22.4,23,9,1,11,9,20,10,1,1,0,FW,129af0db,Rotational Player
288,Julián Álvarez,11,2023-2024,23,ar ARG,Manchester City,eng Premier League,36,2647,29.4,31,5,2,11,8,19,9,2,2,0,MFFW,15ab5a2b,Rotational Player
289,Olivier Giroud,11,2021-2022,34,fr FRA,Milan,it Serie A,29,1892,21.0,22,7,1,11,3,14,9,2,2,0,FW,16ceb862,Rotational Player
290,Rafael Leão,11,2021-2022,22,pt POR,Milan,it Serie A,34,2605,28.9,31,3,1,11,10,21,11,0,0,0,FW,20730eae,Full Starter
291,Jonas Wind,11,2023-2024,24,dk DEN,Wolfsburg,de Bundesliga,34,2651,29.5,31,3,0,11,7,18,11,0,1,1,FW,2077ae86,Rotational Player
292,Benjamin Bourigeaud,11,2021-2022,27,fr FRA,Rennes,fr Ligue 1,38,3193,35.5,38,0,0,11,12,23,11,0,0,0,FWMF,20e73fac,Full Starter
293,Yoane Wissa,11,2024-2025,27,cd COD,Brentford,eng Premier League,20,1571,17.5,19,1,0,11,2,13,11,0,0,0,FW,2500cef9,Rotational Player
294,Tim Kleindienst,11,2024-2025,28,de GER,Gladbach,de Bundesliga,18,1589,17.7,18,0,0,11,5,16,10,1,2,1,FW,258a6f4d,Full Starter
295,Anthony Gordon,11,2023-2024,22,eng ENG,Newcastle Utd,eng Premier League,35,2890,32.1,34,1,0,11,10,21,10,1,1,0,FW,2bd83368,Rotational Player
296,Robin Gosens,11,2020-2021,26,de GER,Atalanta,it Serie A,32,2523,28.0,30,2,0,11,6,17,11,0,0,0,DF,2d970560,Rotational Player
297,Carlton Morris,11,2023-2024,27,eng ENG,Luton Town,eng Premier League,38,2862,31.8,32,6,0,11,4,15,6,5,5,0,FWMF,2da834f1,Full Starter
298,Lorenzo Insigne,11,2021-2022,30,it ITA,Napoli,it Serie A,32,2290,25.4,28,4,1,11,8,19,2,9,13,4,FW,2f557579,Full Starter
299,Raphinha,11,2021-2022,24,br BRA,Leeds United,eng Premier League,35,2915,32.4,34,1,0,11,3,14,7,4,4,0,FWMF,3423f250,Full Starter
300,Gabriel Veiga,11,2022-2023,20,es ESP,Celta Vigo,es La Liga,36,2294,25.5,28,8,0,11,4,15,11,0,0,0,MF,35a6e5c7,Full Starter
301,Thomas Müller,11,2020-2021,30,de GER,Bayern Munich,de Bundesliga,32,2674,29.7,31,1,0,11,19,30,10,1,1,0,MF,3c6089ab,Full Starter
302,André Silva,11,2021-2022,25,pt POR,RB Leipzig,de Bundesliga,33,2076,23.1,24,9,1,11,3,14,8,3,3,0,FW,3effaa34,Rotational Player
303,Kévin Gameiro,11,2021-2022,34,fr FRA,Strasbourg,fr Ligue 1,35,2385,26.5,28,7,0,11,3,14,10,1,3,2,FW,42276181,Rotational Player
304,Roberto Firmino,11,2022-2023,30,br BRA,Liverpool,eng Premier League,25,1213,13.5,13,12,0,11,4,15,11,0,0,0,FWMF,4c370d81,Rotational Player
305,Justin Kluivert,11,2024-2025,25,nl NED,Bournemouth,eng Premier League,22,1440,16.0,18,4,0,11,4,15,5,6,6,0,MFFW,4c3a6744,Rotational Player
306,Darwin Núñez,11,2023-2024,24,uy URU,Liverpool,eng Premier League,36,2047,22.7,22,14,1,11,8,19,11,0,1,1,FW,4d77b365,Rotational Player
307,Sergej Milinković-Savić,11,2021-2022,26,rs SRB,Lazio,it Serie A,37,3100,34.4,36,1,0,11,10,21,11,0,0,0,MF,4e6dbac4,Full Starter
308,Ante Rebić,11,2020-2021,26,hr CRO,Milan,it Serie A,27,1776,19.7,20,7,0,11,4,15,11,0,0,0,FW,536cebe5,Rotational Player
309,Gaël Kakuta,11,2020-2021,29,cd COD,Lens,fr Ligue 1,35,2394,26.6,30,5,0,11,5,16,4,7,9,2,MFFW,5b1bf5e3,Rotational Player
310,Hugo Ekitike,11,2024-2025,22,fr FRA,Eint Frankfurt,de Bundesliga,18,1327,14.7,17,1,0,11,3,14,10,1,1,0,FW,5b92d896,Rotational Player
311,Francesco Caputo,11,2021-2022,33,it ITA,2 Teams,it Serie A,38,2946,32.7,33,5,0,11,4,15,11,0,1,1,FW,5bd72174,Rotational Player
312,Francesco Caputo,11,2020-2021,32,it ITA,Sassuolo,it Serie A,25,1697,18.9,19,6,1,11,5,16,8,3,3,0,FW,5bd72174,Rotational Player
313,Joselu,11,2020-2021,30,es ESP,Alavés,es La Liga,37,3026,33.6,34,3,0,11,3,14,9,2,4,2,FW,6265208f,Full Starter
314,Habib Diallo,11,2021-2022,26,sn SEN,Strasbourg,fr Ligue 1,31,1541,17.1,16,15,2,11,1,12,9,2,2,0,FW,6605d143,Full Starter
315,Borja Iglesias,11,2020-2021,27,es ESP,Betis,es La Liga,28,1411,15.7,15,13,7,11,0,11,6,5,5,0,FW,75645f0e,Rotational Player
316,Ademola Lookman,11,2023-2024,25,ng NGA,Atalanta,it Serie A,31,1894,21.0,22,9,1,11,7,18,11,0,0,0,FWMF,7c104bb7,Rotational Player
317,Lucas Alario,11,2020-2021,27,ar ARG,Leverkusen,de Bundesliga,25,1245,13.8,12,13,4,11,2,13,9,2,2,0,FW,834d0be5,Bench Player
318,Miguel Almirón,11,2022-2023,28,py PAR,Newcastle Utd,eng Premier League,34,2491,27.7,29,5,0,11,2,13,11,0,0,0,FW,862a1c15,Full Starter
319,Riyad Mahrez,11,2021-2022,30,dz ALG,Manchester City,eng Premier League,28,1498,16.6,15,13,8,11,5,16,7,4,5,1,FW,892d5bb1,Rotational Player
320,Dries Mertens,11,2021-2022,34,be BEL,Napoli,it Serie A,30,1384,15.4,16,14,3,11,1,12,10,1,1,0,FWMF,89b2c8a9,Rotational Player
321,Mikel Oyarzabal,11,2020-2021,23,es ESP,Real Sociedad,es La Liga,33,2408,26.8,30,3,0,11,8,19,5,6,7,1,FWMF,8c3c640c,Rotational Player
322,Alexander Isak,11,2022-2023,22,se SWE,2 Teams,2 Comps,24,1674,18.6,19,5,0,11,1,12,9,2,2,0,FW,8e92be30,Rotational Player
323,Sheraldo Becker,11,2022-2023,27,sr SUR,Union Berlin,de Bundesliga,34,2554,28.4,33,1,0,11,7,18,11,0,0,0,FW,8eb55dbb,Rotational Player
324,Ante Budimir,11,2020-2021,29,hr CRO,Osasuna,es La Liga,30,1625,18.1,18,12,1,11,0,11,11,0,0,0,FW,8f3565b3,Rotational Player
325,Serhou Guirassy,11,2022-2023,26,gn GUI,2 Teams,2 Comps,23,1669,18.5,20,3,1,11,0,11,9,2,2,0,MF,923f4dda,Rotational Player
326,Mason Mount,11,2021-2022,22,eng ENG,Chelsea,eng Premier League,32,2363,26.3,27,5,3,11,10,21,10,1,1,0,MF,9674002f,Full Starter
327,Bradley Barcola,11,2024-2025,21,fr FRA,Paris S-G,fr Ligue 1,19,1250,13.9,16,3,0,11,3,14,11,0,0,0,FW,a0d55a09,Rotational Player
328,Marcus Rashford,11,2020-2021,22,eng ENG,Manchester Utd,eng Premier League,37,2920,32.4,33,4,1,11,9,20,11,0,0,0,FW,a1d5bd30,Rotational Player
329,Hwang Ui-jo,11,2021-2022,28,kr KOR,Bordeaux,fr Ligue 1,32,2508,27.9,29,3,0,11,2,13,11,0,0,0,FW,a2d873dd,Full Starter
330,M'Bala Nzola,11,2020-2021,23,ao ANG,Spezia,it Serie A,25,1896,21.1,21,4,0,11,3,14,7,4,4,0,FW,a4948e67,Rotational Player
331,Gareth Bale,11,2020-2021,31,wls WAL,Tottenham,eng Premier League,20,920,10.2,10,10,10,11,2,13,11,0,0,0,FW,a58bb1e1,Rotational Player
332,Luis Suárez,11,2021-2022,34,uy URU,Atlético Madrid,es La Liga,35,1835,20.4,20,15,2,11,2,13,9,2,3,1,FW,a6154613,Rotational Player
333,Hirving Lozano,11,2020-2021,25,mx MEX,Napoli,it Serie A,32,1965,21.8,23,9,0,11,3,14,11,0,0,0,FW,a69e4806,Rotational Player
334,Marius Bülter,11,2022-2023,29,de GER,Schalke 04,de Bundesliga,33,2598,28.9,30,3,0,11,1,12,7,4,4,0,FWMF,ab5b7dc1,Rotational Player
335,Eberechi Eze,11,2023-2024,25,eng ENG,Crystal Palace,eng Premier League,27,2055,22.8,24,3,0,11,4,15,10,1,1,0,MFFW,ae4fc6a4,Full Starter
336,Ollie Watkins,11,2021-2022,25,eng ENG,Aston Villa,eng Premier League,35,2952,32.8,33,2,0,11,2,13,10,1,1,0,FW,aed3a70f,Full Starter
337,Matheus Pereira,11,2020-2021,24,br BRA,West Brom,eng Premier League,33,2577,28.6,30,3,0,11,6,17,7,4,4,0,MFFW,b04ee927,Full Starter
338,Ousmane Dembélé,11,2024-2025,27,fr FRA,Paris S-G,fr Ligue 1,17,1048,11.6,12,5,1,11,4,15,10,1,1,0,FW,b19db005,Rotational Player
339,Wilfried Zaha,11,2020-2021,27,ci CIV,Crystal Palace,eng Premier League,30,2612,29.0,29,1,0,11,2,13,9,2,2,0,FW,b2bc3b1f,Full Starter
340,Gabriel Jesus,11,2022-2023,25,br BRA,Arsenal,eng Premier League,26,2064,22.9,24,2,0,11,6,17,10,1,1,0,FW,b66315ae,Rotational Player
341,Bukayo Saka,11,2021-2022,19,eng ENG,Arsenal,eng Premier League,38,2978,33.1,36,2,0,11,7,18,9,2,2,0,FWMF,bc7dc64d,Full Starter
342,Renaud Ripart,11,2020-2021,27,fr FRA,Nîmes,fr Ligue 1,38,3054,33.9,35,3,0,11,0,11,5,6,7,1,MFFW,beae3a73,Rotational Player
343,Matìas Soulé,11,2023-2024,20,ar ARG,2 Teams,it Serie A,36,3121,34.7,36,0,2,11,3,14,6,5,6,1,FWMF,c13ddd3e,Full Starter
344,Sadio Mané,11,2020-2021,28,sn SEN,Liverpool,eng Premier League,35,2810,31.2,31,4,0,11,7,18,11,0,0,0,FW,c691bfe2,Full Starter
345,Jonathan David,11,2024-2025,24,ca CAN,Lille,fr Ligue 1,18,1449,16.1,15,3,0,11,2,13,6,5,6,1,FW,ce50fd99,Full Starter
346,Mattia Destro,11,2020-2021,29,it ITA,Genoa,it Serie A,29,1606,17.8,22,7,6,11,1,12,11,0,0,0,FW,d7d32194,Rotational Player
347,Franck Honorat,11,2021-2022,24,fr FRA,Brest,fr Ligue 1,34,2899,32.2,34,0,0,11,4,15,11,0,0,0,FWMF,db7849ca,Full Starter
348,Silas Katompa,11,2020-2021,21,cd COD,Stuttgart,de Bundesliga,25,1919,21.3,24,1,0,11,4,15,8,3,3,0,DFFW,de4cac2d,Rotational Player
349,Khvicha Kvaratskhelia,11,2023-2024,22,ge GEO,Napoli,it Serie A,34,2737,30.4,32,2,0,11,6,17,11,0,0,0,FW,dea88efd,Full Starter
350,Riccardo Orsolini,11,2022-2023,25,it ITA,Bologna,it Serie A,32,2124,23.6,22,10,2,11,4,15,8,3,3,0,FW,e14ec482,Rotational Player
351,Gonçalo Guedes,11,2021-2022,24,pt POR,Valencia,es La Liga,36,2606,29.0,30,6,1,11,6,17,10,1,2,1,FWMF,e6bc67d7,Rotational Player
352,Florian Wirtz,11,2023-2024,20,de GER,Leverkusen,de Bundesliga,32,2372,26.4,26,6,0,11,11,22,10,1,1,0,MF,e7fcf289,Rotational Player
353,Phil Foden,11,2022-2023,22,eng ENG,Manchester City,eng Premier League,32,1842,20.5,22,10,1,11,6,17,11,0,0,0,FW,ed1e53f3,Rotational Player
354,Beto,11,2021-2022,23,gw GNB,Udinese,it Serie A,28,2173,24.1,24,4,0,11,0,11,11,0,0,0,FW,ed5c0319,Rotational Player
355,Gonçalo Ramos,11,2023-2024,22,pt POR,Paris S-G,fr Ligue 1,29,1419,15.8,16,13,3,11,1,12,10,1,1,0,FW,f63cda26,Rotational Player
356,Max Kruse,11,2020-2021,32,de GER,Union Berlin,de Bundesliga,22,1629,18.1,19,3,1,11,5,16,6,5,6,1,FWMF,f9446dcd,Rotational Player
357,Richarlison,11,2023-2024,26,br BRA,Tottenham,eng Premier League,28,1491,16.6,18,10,1,11,4,15,11,0,0,0,FW,fa031b34,Full Starter
358,Carlos Soler,11,2020-2021,23,es ESP,Valencia,es La Liga,32,2735,30.4,31,1,1,11,8,19,4,7,9,2,MF,fed17f5a,Full Starter
359,Carlos Soler,11,2021-2022,24,es ESP,Valencia,es La Liga,32,2474,27.5,28,4,0,11,5,16,4,7,7,0,MF,fed17f5a,Full Starter
360,Marko Arnautović,10,2022-2023,33,at AUT,Bologna,it Serie A,21,1530,17.0,18,3,2,10,0,10,7,3,3,0,FW,00459419,Rotational Player
361,Robin Hack,10,2023-2024,24,de GER,Gladbach,de Bundesliga,29,1348,15.0,14,15,3,10,2,12,10,0,0,0,FWMF,0174ba21,Rotational Player
362,Elijah Adebayo,10,2023-2024,25,eng ENG,Luton Town,eng Premier League,27,1419,15.8,16,11,0,10,0,10,10,0,0,0,FW,0480ebc7,Rotational Player
363,Elye Wahi,10,2021-2022,18,fr FRA,Montpellier,fr Ligue 1,33,1786,19.8,21,12,2,10,1,11,10,0,0,0,FW,0d7b6576,Rotational Player
364,Eric Maxim Choupo-Moting,10,2022-2023,33,cm CMR,Bayern Munich,de Bundesliga,19,1112,12.4,14,5,1,10,2,12,10,0,1,1,FW,0e6bc38c,Bench Player
365,Emile Smith Rowe,10,2021-2022,21,eng ENG,Arsenal,eng Premier League,33,1921,21.3,21,12,2,10,2,12,10,0,0,0,MFFW,17695062,Rotational Player
366,Diogo Jota,10,2023-2024,26,pt POR,Liverpool,eng Premier League,21,1145,12.7,14,7,1,10,3,13,10,0,0,0,FW,178ae8f8,Rotational Player
367,Cengiz Ünder,10,2021-2022,24,tr TUR,Marseille,fr Ligue 1,32,2200,24.4,25,7,1,10,2,12,9,1,1,0,FWMF,1880614f,Full Starter
368,Yoane Wissa,10,2020-2021,23,cd COD,Lorient,fr Ligue 1,38,2674,29.7,30,8,0,10,4,14,6,4,5,1,MFFW,2500cef9,Rotational Player
369,Wahbi Khazri,10,2021-2022,30,tn TUN,Saint-Étienne,fr Ligue 1,30,2225,24.7,26,4,0,10,0,10,6,4,4,0,FWMF,2677a1de,Rotational Player
370,Marcus Ingvartsen,10,2022-2023,26,dk DEN,Mainz 05,de Bundesliga,28,1314,14.6,16,12,2,10,0,10,6,4,4,0,FWMF,271b8617,Rotational Player
371,Jamal Musiala,10,2023-2024,20,de GER,Bayern Munich,de Bundesliga,24,1755,19.5,20,4,1,10,5,15,10,0,0,0,MFFW,2c0558b8,Rotational Player
372,Emmanuel Dennis,10,2021-2022,23,ng NGA,Watford,eng Premier League,33,2581,28.7,30,3,0,10,6,16,10,0,0,0,FWMF,2c44a35d,Full Starter
373,Charles De Ketelaere,10,2023-2024,22,be BEL,Atalanta,it Serie A,35,2026,22.5,25,10,1,10,8,18,9,1,1,0,FWMF,2ef7c612,Rotational Player
374,James Ward-Prowse,10,2021-2022,26,eng ENG,Southampton,eng Premier League,36,3215,35.7,36,0,0,10,5,15,6,4,4,0,MF,3515d404,Full Starter
375,Sebastian Polter,10,2021-2022,30,de GER,Bochum,de Bundesliga,33,2341,26.0,27,6,0,10,1,11,9,1,2,1,FW,3745e8bd,Full Starter
376,Grejohn Kyei,10,2022-2023,26,fr FRA,Clermont Foot,fr Ligue 1,37,2232,24.8,26,11,0,10,3,13,6,4,6,2,FW,397ba086,Full Starter
377,Leon Bailey,10,2023-2024,25,jm JAM,Aston Villa,eng Premier League,35,2068,23.0,22,13,1,10,9,19,10,0,0,0,MFFW,3a233281,Rotational Player
378,Kévin Gameiro,10,2022-2023,35,fr FRA,Strasbourg,fr Ligue 1,34,2098,23.3,23,11,1,10,0,10,9,1,2,1,FW,42276181,Rotational Player
379,Jorge Molina,10,2021-2022,39,es ESP,Granada,es La Liga,35,1966,21.8,19,16,2,10,5,15,10,0,1,1,FW,43f71e77,Rotational Player
380,Marco Asensio,10,2021-2022,25,es ESP,Real Madrid,es La Liga,31,1731,19.2,19,12,2,10,0,10,10,0,0,0,FWMF,45af8a54,Rotational Player
381,Rasmus Højlund,10,2023-2024,20,dk DEN,Manchester Utd,eng Premier League,30,2158,24.0,25,5,0,10,2,12,10,0,0,0,FW,491a433d,Rotational Player
382,Jordan Veretout,10,2020-2021,27,fr FRA,Roma,it Serie A,29,2053,22.8,25,4,0,10,2,12,5,5,5,0,MF,4a56052c,Full Starter
383,Eren Dinkçi,10,2023-2024,21,de GER,Heidenheim,de Bundesliga,33,2650,29.4,33,0,0,10,5,15,10,0,0,0,FWMF,4ccd8957,Full Starter
384,Bruno Fernandes,10,2021-2022,26,pt POR,Manchester Utd,eng Premier League,36,3111,34.6,35,1,0,10,6,16,10,0,2,2,MF,507c7bdf,Full Starter
385,Bruno Fernandes,10,2023-2024,28,pt POR,Manchester Utd,eng Premier League,35,3118,34.6,35,0,0,10,8,18,6,4,5,1,MFFW,507c7bdf,Full Starter
386,Edinson Cavani,10,2020-2021,33,uy URU,Manchester Utd,eng Premier League,26,1375,15.3,13,13,0,10,3,13,10,0,0,0,FW,527f063d,Rotational Player
387,Nicolas Pépé,10,2020-2021,25,ci CIV,Arsenal,eng Premier League,29,1616,18.0,16,13,6,10,1,11,9,1,1,0,FW,57e3f0c7,Rotational Player
388,Hugo Ekitike,10,2021-2022,19,fr FRA,Reims,fr Ligue 1,24,1273,14.1,15,9,0,10,3,13,9,1,2,1,FW,5b92d896,Rotational Player
389,Romelu Lukaku,10,2022-2023,29,be BEL,Inter,it Serie A,25,1660,18.4,19,6,1,10,6,16,8,2,2,0,FW,5eae500a,Rotational Player
390,Ludovic Blas,10,2020-2021,22,fr FRA,Nantes,fr Ligue 1,36,2787,31.0,32,4,1,10,4,14,10,0,0,0,MFFW,6191093d,Full Starter
391,Ludovic Blas,10,2021-2022,23,fr FRA,Nantes,fr Ligue 1,35,2961,32.9,35,0,0,10,5,15,5,5,5,0,MFFW,6191093d,Full Starter
392,Joselu,10,2023-2024,33,es ESP,Real Madrid,es La Liga,34,1687,18.7,15,19,2,10,2,12,10,0,2,2,FW,6265208f,Full Starter
393,Borja Mayoral,10,2020-2021,23,es ESP,2 Teams,2 Comps,33,1574,17.5,18,15,5,10,3,13,10,0,0,0,FW,64e8ed6d,Rotational Player
394,Tomáš Souček,10,2020-2021,25,cz CZE,West Ham,eng Premier League,38,3419,38.0,38,0,0,10,1,11,10,0,0,0,MF,6613c819,Full Starter
395,Iñaki Williams,10,2022-2023,28,gh GHA,Athletic Club,es La Liga,36,2836,31.5,34,2,0,10,3,13,9,1,2,1,FW,6a99e0b1,Full Starter
396,Giacomo Raspadori,10,2021-2022,21,it ITA,Sassuolo,it Serie A,36,2740,30.4,32,4,0,10,4,14,10,0,0,0,MFFW,6e058f06,Rotational Player
397,Vinicius Júnior,10,2022-2023,22,br BRA,Real Madrid,es La Liga,33,2823,31.4,32,1,0,10,9,19,10,0,0,0,FW,7111d552,Rotational Player
398,Romain Faivre,10,2021-2022,23,fr FRA,2 Teams,fr Ligue 1,35,2684,29.8,29,6,0,10,5,15,5,5,5,0,FWMF,745ca0a3,Rotational Player
399,Borja Iglesias,10,2021-2022,28,es ESP,Betis,es La Liga,33,1573,17.5,18,15,4,10,0,10,7,3,3,0,FW,75645f0e,Rotational Player
400,Dušan Vlahović,10,2022-2023,22,rs SRB,Juventus,it Serie A,27,1925,21.4,22,5,1,10,2,12,8,2,3,1,FW,79443529,Full Starter
401,Ademola Lookman,10,2024-2025,26,ng NGA,Atalanta,it Serie A,19,1323,14.7,17,2,1,10,5,15,9,1,1,0,FWMF,7c104bb7,Rotational Player
402,Tino Kadewere,10,2020-2021,24,zw ZIM,Lyon,fr Ligue 1,33,2009,22.3,24,9,0,10,3,13,10,0,0,0,FW,7d08063d,Rotational Player
403,Gerard Moreno,10,2023-2024,31,es ESP,Villarreal,es La Liga,30,2215,24.6,28,2,2,10,6,16,8,2,3,1,FW,81f0781e,Rotational Player
404,Alexis Mac Allister,10,2022-2023,23,ar ARG,Brighton,eng Premier League,35,2886,32.1,31,4,0,10,2,12,4,6,6,0,MF,83d074ff,Full Starter
405,Jérémy Le Douaron,10,2022-2023,24,fr FRA,Brest,fr Ligue 1,32,2071,23.0,24,8,0,10,3,13,10,0,0,0,MFFW,88c4d190,Rotational Player
406,Serge Gnabry,10,2020-2021,25,de GER,Bayern Munich,de Bundesliga,27,1644,18.3,20,7,0,10,2,12,10,0,0,0,FWMF,88e357ef,Rotational Player
407,Victor Osimhen,10,2020-2021,21,ng NGA,Napoli,it Serie A,24,1573,17.5,16,8,1,10,3,13,10,0,0,0,FW,8c90fd7a,Rotational Player
408,Michael Gregoritsch,10,2022-2023,28,at AUT,Freiburg,de Bundesliga,30,2150,23.9,27,3,1,10,4,14,10,0,0,0,FW,8e235926,Rotational Player
409,Ante Budimir,10,2024-2025,33,hr CRO,Osasuna,es La Liga,21,1545,17.2,18,3,0,10,1,11,6,4,4,0,FW,8f3565b3,Rotational Player
410,Rodrygo,10,2023-2024,22,br BRA,Real Madrid,es La Liga,34,2380,26.4,28,6,3,10,5,15,10,0,1,1,FW,8f5e92a6,Rotational Player
411,Serhou Guirassy,10,2020-2021,24,gn GUI,Rennes,fr Ligue 1,27,1764,19.6,19,8,0,10,1,11,9,1,1,0,FW,923f4dda,Rotational Player
412,Son Heung-min,10,2022-2023,30,kr KOR,Tottenham,eng Premier League,36,2888,32.1,33,3,0,10,6,16,10,0,0,0,MFFW,92e7e919,Full Starter
413,Teun Koopmeiners,10,2022-2023,24,nl NED,Atalanta,it Serie A,33,2858,31.8,32,1,0,10,4,14,8,2,4,2,MF,a26fb8aa,Full Starter
414,Amine Gouiri,10,2021-2022,21,dz ALG,Nice,fr Ligue 1,38,2754,30.6,32,6,0,10,9,19,7,3,5,2,FWMF,aad56ca3,Full Starter
415,Christian Benteke,10,2020-2021,29,be BEL,Crystal Palace,eng Premier League,30,1816,20.2,21,9,4,10,1,11,10,0,0,0,FW,ab070c55,Rotational Player
416,Michail Antonio,10,2021-2022,31,jm JAM,West Ham,eng Premier League,36,2971,33.0,34,2,1,10,8,18,10,0,1,1,FW,ac05f970,Rotational Player
417,Michail Antonio,10,2020-2021,30,jm JAM,West Ham,eng Premier League,26,1974,21.9,24,2,0,10,5,15,10,0,0,0,FW,ac05f970,Rotational Player
418,Eberechi Eze,10,2022-2023,24,eng ENG,Crystal Palace,eng Premier League,38,2636,29.3,30,8,0,10,4,14,9,1,1,0,MFFW,ae4fc6a4,Full Starter
419,Ollie Watkins,10,2024-2025,28,eng ENG,Aston Villa,eng Premier League,23,1596,17.7,19,4,0,10,5,15,8,2,2,0,FW,aed3a70f,Full Starter
420,Álex Grimaldo,10,2023-2024,27,es ESP,Leverkusen,de Bundesliga,33,2784,30.9,31,2,0,10,13,23,10,0,0,0,DF,b1f4086c,Full Starter
421,Raheem Sterling,10,2020-2021,25,eng ENG,Manchester City,eng Premier League,31,2536,28.2,28,3,5,10,7,17,10,0,1,1,FW,b400bde0,Rotational Player
422,Rafa Mir,10,2021-2022,24,es ESP,Sevilla,es La Liga,34,1808,20.1,18,16,0,10,0,10,10,0,0,0,FW,bbf5c11b,Rotational Player
423,Alassane Pléa,10,2021-2022,28,fr FRA,Gladbach,de Bundesliga,33,2070,23.0,24,9,1,10,6,16,7,3,3,0,MFFW,bc6bd723,Rotational Player
424,Oihan Sancet,10,2022-2023,22,es ESP,Athletic Club,es La Liga,36,2532,28.1,32,4,0,10,2,12,8,2,2,0,MF,bdb624a3,Rotational Player
425,Arnaud Kalimuendo,10,2023-2024,21,fr FRA,Rennes,fr Ligue 1,30,2139,23.8,25,5,0,10,1,11,8,2,2,0,FW,bf4c41f9,Rotational Player
426,Federico Bonazzoli,10,2021-2022,24,it ITA,Salernitana,it Serie A,32,1866,20.7,19,13,1,10,0,10,8,2,2,0,FWMF,bf57eaab,Rotational Player
427,Zakaria Aboukhlal,10,2022-2023,22,ma MAR,Toulouse,fr Ligue 1,37,2473,27.5,28,9,0,10,5,15,10,0,0,0,FWMF,c2a6033c,Rotational Player
428,Michael Olise,10,2023-2024,21,fr FRA,Crystal Palace,eng Premier League,19,1275,14.2,14,5,0,10,6,16,9,1,1,0,FWMF,c4486bac,Rotational Player
429,Duván Zapata,10,2021-2022,30,co COL,Atalanta,it Serie A,24,1722,19.1,20,4,2,10,4,14,7,3,3,0,FW,d3de9af0,Rotational Player
430,Pierre-Emerick Aubameyang,10,2020-2021,31,ga GAB,Arsenal,eng Premier League,29,2332,25.9,26,3,3,10,3,13,8,2,2,0,FW,d5dd5f1f,Full Starter
431,Mattia Zaccagni,10,2022-2023,27,it ITA,Lazio,it Serie A,35,2770,30.8,33,2,0,10,6,16,9,1,1,0,FW,d85c238b,Full Starter
432,Willian José,10,2023-2024,31,br BRA,Betis,es La Liga,33,1971,21.9,25,8,2,10,5,15,10,0,0,0,FW,d87e2cae,Rotational Player
433,Matheus Cunha,10,2024-2025,25,br BRA,Wolves,eng Premier League,22,1785,19.8,20,2,0,10,4,14,10,0,0,0,MFFW,dc62b55d,Rotational Player
434,Paulo Dybala,10,2021-2022,27,ar ARG,Juventus,it Serie A,29,2061,22.9,26,3,0,10,5,15,9,1,2,1,FWMF,e0921a4f,Rotational Player
435,Riccardo Orsolini,10,2023-2024,26,it ITA,Bologna,it Serie A,33,1792,19.9,19,14,1,10,2,12,8,2,3,1,FWMF,e14ec482,Rotational Player
436,Taiwo Awoniyi,10,2022-2023,24,ng NGA,Nott'ham Forest,eng Premier League,27,1404,15.6,17,10,2,10,1,11,10,0,0,0,FW,e5478b87,Rotational Player
437,Beto,10,2022-2023,24,gw GNB,Udinese,it Serie A,33,2129,23.7,23,10,0,10,1,11,9,1,1,0,FW,ed5c0319,Rotational Player
438,James Maddison,10,2022-2023,25,eng ENG,Leicester City,eng Premier League,30,2480,27.6,28,2,0,10,9,19,9,1,2,1,MFFW,ee38d9c5,Rotational Player
439,Arnaut Danjuma,10,2021-2022,24,nl NED,Villarreal,es La Liga,23,1472,16.4,17,6,0,10,3,13,7,3,3,0,FW,f08490a6,Rotational Player
440,Karim Onisiwo,10,2022-2023,30,at AUT,Mainz 05,de Bundesliga,31,2539,28.2,28,3,0,10,2,12,10,0,0,0,FWMF,f26834c7,Rotational Player
441,Richarlison,10,2021-2022,24,br BRA,Everton,eng Premier League,30,2523,28.0,28,2,0,10,5,15,7,3,3,0,FW,fa031b34,Full Starter
442,Martin Braithwaite,10,2022-2023,31,dk DEN,Espanyol,es La Liga,31,2456,27.3,29,2,0,10,2,12,10,0,0,0,FWMF,fd771f95,Full Starter
443,Anwar El Ghazi,10,2020-2021,25,nl NED,Aston Villa,eng Premier League,28,1613,17.9,17,11,6,10,0,10,6,4,4,0,FW,ffa90327,Rotational Player
444,Ángel Correa,9,2020-2021,25,ar ARG,Atlético Madrid,es La Liga,38,2393,26.6,29,9,0,9,8,17,9,0,0,0,FWMF,01eb744d,Rotational Player
445,Ángel Correa,9,2022-2023,27,ar ARG,Atlético Madrid,es La Liga,35,1455,16.2,13,22,1,9,1,10,9,0,0,0,FWMF,01eb744d,Rotational Player
446,Ángel Correa,9,2023-2024,28,ar ARG,Atlético Madrid,es La Liga,32,1528,17.0,14,18,3,9,2,11,8,1,1,0,FWMF,01eb744d,Rotational Player
447,Denis Bouanga,9,2021-2022,26,ga GAB,Saint-Étienne,fr Ligue 1,34,2436,27.1,28,6,0,9,6,15,9,0,0,0,FWMF,0b0cbe5b,Full Starter
448,Breel Embolo,9,2021-2022,24,ch SUI,Gladbach,de Bundesliga,29,2166,24.1,24,5,0,9,3,12,9,0,0,0,FW,0b4f388a,Rotational Player
449,Dodi Lukebakio,9,2024-2025,26,be BEL,Sevilla,es La Liga,21,1719,19.1,20,1,0,9,0,9,8,1,1,0,FW,0c61c77c,Rotational Player
450,Elye Wahi,9,2023-2024,20,fr FRA,2 Teams,fr Ligue 1,28,1706,19.0,20,8,1,9,3,12,8,1,1,0,FW,0d7b6576,Rotational Player
451,Alberth Elis,9,2021-2022,25,hn HON,Bordeaux,fr Ligue 1,20,1409,15.7,16,4,1,9,1,10,9,0,1,1,FWMF,104b4ad3,Rotational Player
452,Donyell Malen,9,2022-2023,23,nl NED,Dortmund,de Bundesliga,26,1706,19.0,22,4,2,9,6,15,9,0,0,0,FW,116c35df,Rotational Player
453,Álvaro Morata,9,2021-2022,28,es ESP,Juventus,it Serie A,35,2302,25.6,26,9,1,9,4,13,8,1,1,0,FW,129af0db,Rotational Player
454,Julián Álvarez,9,2022-2023,22,ar ARG,Manchester City,eng Premier League,31,1465,16.3,13,18,6,9,0,9,8,1,1,0,FWMF,15ab5a2b,Rotational Player
455,Daichi Kamada,9,2022-2023,25,jp JPN,Eint Frankfurt,de Bundesliga,32,2265,25.2,25,7,1,9,6,15,6,3,3,0,MF,15b287da,Rotational Player
456,Rodrigo De Paul,9,2020-2021,26,ar ARG,Udinese,it Serie A,36,3201,35.6,36,0,0,9,9,18,6,3,3,0,MF,162efffd,Rotational Player
457,Takefusa Kubo,9,2022-2023,21,jp JPN,Real Sociedad,es La Liga,35,2439,27.1,29,6,2,9,4,13,9,0,0,0,FWMF,16aa3654,Rotational Player
458,Diogo Jota,9,2020-2021,23,pt POR,2 Teams,eng Premier League,19,1112,12.4,12,7,1,9,0,9,9,0,0,0,FW,178ae8f8,Rotational Player
459,Steve Mounié,9,2021-2022,26,bj BEN,Brest,fr Ligue 1,35,2312,25.7,25,10,0,9,2,11,7,2,2,0,FW,19ba6c6d,Rotational Player
460,Steve Mounié,9,2020-2021,25,bj BEN,Brest,fr Ligue 1,35,2680,29.8,31,4,0,9,4,13,8,1,2,1,FW,19ba6c6d,Rotational Player
461,Sergio Arribas,9,2023-2024,21,es ESP,Almería,es La Liga,34,2047,22.7,22,12,4,9,4,13,9,0,0,0,MFFW,1e465e70,Rotational Player
462,Rafael Leão,9,2023-2024,24,pt POR,Milan,it Serie A,34,2512,27.9,29,5,0,9,9,18,9,0,0,0,FW,20730eae,Full Starter
463,Benjamin Bourigeaud,9,2023-2024,29,fr FRA,Rennes,fr Ligue 1,32,2425,26.9,29,3,0,9,6,15,2,7,7,0,MFFW,20e73fac,Full Starter
464,Cristhian Stuani,9,2023-2024,36,uy URU,Girona,es La Liga,31,804,8.9,5,26,1,9,3,12,9,0,0,0,FW,220c11f1,Bench Player
465,Cristhian Stuani,9,2022-2023,35,uy URU,Girona,es La Liga,32,1090,12.1,8,24,1,9,0,9,4,5,6,1,FW,220c11f1,Bench Player
466,Jamal Musiala,9,2024-2025,21,de GER,Bayern Munich,de Bundesliga,16,1115,12.4,13,3,0,9,2,11,9,0,0,0,MF,2c0558b8,Rotational Player
467,Stephy Mavididi,9,2020-2021,22,eng ENG,Montpellier,fr Ligue 1,35,2030,22.6,23,12,0,9,0,9,9,0,0,0,FWMF,30144daa,Rotational Player
468,James Ward-Prowse,9,2022-2023,27,eng ENG,Southampton,eng Premier League,38,3371,37.5,38,0,0,9,4,13,7,2,4,2,MF,3515d404,Full Starter
469,Marco Reus,9,2021-2022,32,de GER,Dortmund,de Bundesliga,29,2503,27.8,29,0,0,9,13,22,9,0,0,0,MFFW,36a3ff67,Rotational Player
470,Leon Bailey,9,2020-2021,22,jm JAM,Leverkusen,de Bundesliga,30,2141,23.8,25,5,0,9,8,17,9,0,0,0,FWMF,3a233281,Rotational Player
471,Edin Džeko,9,2022-2023,36,ba BIH,Inter,it Serie A,33,1732,19.2,18,15,5,9,3,12,9,0,0,0,FW,3bb7f478,Rotational Player
472,Pedro,9,2021-2022,34,es ESP,Lazio,it Serie A,32,2033,22.6,25,7,0,9,4,13,9,0,0,0,FW,3ca7254a,Rotational Player
473,Harvey Barnes,9,2020-2021,22,eng ENG,Leicester City,eng Premier League,25,1945,21.6,22,3,1,9,4,13,9,0,0,0,FWMF,3ea50f67,Rotational Player
474,Moussa Koné,9,2020-2021,23,sn SEN,Nîmes,fr Ligue 1,33,1755,19.5,21,12,3,9,0,9,9,0,0,0,FW,3ef68782,Rotational Player
475,Milan Đurić,9,2023-2024,33,ba BIH,2 Teams,it Serie A,37,2461,27.3,26,11,0,9,2,11,8,1,3,2,FW,405f6586,Rotational Player
476,Marco Asensio,9,2022-2023,26,es ESP,Real Madrid,es La Liga,31,1442,16.0,15,16,6,9,6,15,9,0,1,1,FWMF,45af8a54,Rotational Player
477,Rasmus Højlund,9,2022-2023,19,dk DEN,Atalanta,it Serie A,32,1834,20.4,20,12,3,9,2,11,9,0,0,0,FW,491a433d,Rotational Player
478,Isaac Palazón Camacho,9,2022-2023,27,es ESP,Rayo Vallecano,es La Liga,37,2965,32.9,36,1,0,9,5,14,8,1,3,2,FWMF,49dbab27,Full Starter
479,Timo Werner,9,2022-2023,26,de GER,RB Leipzig,de Bundesliga,27,1937,21.5,23,4,0,9,3,12,9,0,0,0,FWMF,49fe9070,Rotational Player
480,Lorenzo Pellegrini,9,2021-2022,25,it ITA,Roma,it Serie A,28,2289,25.4,27,1,0,9,3,12,7,2,3,1,MF,4a5a45c7,Full Starter
481,Roberto Firmino,9,2020-2021,28,br BRA,Liverpool,eng Premier League,36,2838,31.5,33,3,0,9,7,16,9,0,0,0,FW,4c370d81,Rotational Player
482,Darwin Núñez,9,2022-2023,23,uy URU,Liverpool,eng Premier League,29,1695,18.8,19,10,0,9,3,12,9,0,0,0,FW,4d77b365,Rotational Player
483,Sergej Milinković-Savić,9,2022-2023,27,rs SRB,Lazio,it Serie A,36,3022,33.6,34,2,1,9,8,17,9,0,0,0,MF,4e6dbac4,Full Starter
484,Martin Terrier,9,2020-2021,23,fr FRA,Rennes,fr Ligue 1,34,2436,27.1,30,4,0,9,7,16,8,1,1,0,FWMF,5148dcc5,Full Starter
485,Martin Terrier,9,2022-2023,25,fr FRA,Rennes,fr Ligue 1,16,1319,14.7,16,0,0,9,4,13,9,0,0,0,FWMF,5148dcc5,Full Starter
486,Luis Alberto,9,2020-2021,27,es ESP,Lazio,it Serie A,34,2618,29.1,33,1,0,9,2,11,9,0,0,0,MF,5294a83f,Full Starter
487,Domenico Berardi,9,2023-2024,28,it ITA,Sassuolo,it Serie A,17,1431,15.9,17,0,1,9,3,12,4,5,5,0,FW,53a0e358,Rotational Player
488,Vincenzo Grifo,9,2021-2022,28,it ITA,Freiburg,de Bundesliga,34,2775,30.8,33,1,0,9,7,16,4,5,6,1,MFFW,54e4866f,Full Starter
489,Vincenzo Grifo,9,2020-2021,27,it ITA,Freiburg,de Bundesliga,31,2313,25.7,27,4,1,9,10,19,5,4,4,0,MFFW,54e4866f,Full Starter
490,Patrik Schick,9,2020-2021,24,cz CZE,Leverkusen,de Bundesliga,29,1866,20.7,20,9,0,9,1,10,9,0,0,0,FW,5d4f7d61,Rotational Player
491,Matteo Politano,9,2020-2021,26,it ITA,Napoli,it Serie A,37,1908,21.2,22,15,1,9,4,13,9,0,0,0,FWMF,5e861944,Rotational Player
492,Romelu Lukaku,9,2024-2025,31,be BEL,Napoli,it Serie A,20,1528,17.0,19,1,0,9,6,15,6,3,4,1,FW,5eae500a,Rotational Player
493,Kevin Volland,9,2021-2022,29,de GER,Monaco,fr Ligue 1,34,2436,27.1,29,5,0,9,9,18,8,1,1,0,MFFW,64f69877,Rotational Player
494,Habib Diallo,9,2020-2021,25,sn SEN,2 Teams,fr Ligue 1,36,2465,27.4,28,8,1,9,3,12,8,1,1,0,FW,6605d143,Full Starter
495,Neymar,9,2020-2021,28,br BRA,Paris S-G,fr Ligue 1,18,1415,15.7,15,3,0,9,5,14,4,5,6,1,MFFW,69384e5d,Rotational Player
496,Bryan Mbeumo,9,2022-2023,22,cm CMR,Brentford,eng Premier League,38,2906,32.3,36,2,0,9,8,17,8,1,1,0,FW,6afaebf2,Full Starter
497,Bryan Mbeumo,9,2023-2024,23,cm CMR,Brentford,eng Premier League,25,1960,21.8,22,3,0,9,6,15,6,3,3,0,FW,6afaebf2,Full Starter
498,Téji Savanier,9,2023-2024,31,fr FRA,Montpellier,fr Ligue 1,32,2765,30.7,32,0,0,9,6,15,2,7,7,0,MF,6bde367b,Full Starter
499,Douglas Luiz,9,2023-2024,25,br BRA,Aston Villa,eng Premier League,35,2993,33.3,35,0,0,9,5,14,5,4,4,0,MF,6f7d826d,Full Starter
500,Branimir Hrgota,9,2021-2022,28,se SWE,Greuther Fürth,de Bundesliga,34,2777,30.9,33,1,0,9,5,14,4,5,5,0,FW,710fbdd1,Full Starter
501,Jeremie Frimpong,9,2023-2024,22,nl NED,Leverkusen,de Bundesliga,31,2251,25.0,27,4,2,9,7,16,9,0,0,0,DF,74f2e748,Full Starter
502,Arnaud Nordin,9,2022-2023,24,fr FRA,Montpellier,fr Ligue 1,36,2401,26.7,30,6,1,9,3,12,9,0,0,0,FW,7b9a9e25,Rotational Player
503,Iago Aspas,9,2023-2024,35,es ESP,Celta Vigo,es La Liga,35,2707,30.1,31,4,1,9,10,19,6,3,5,2,FW,7dcf86f6,Full Starter
504,Jesse Lingard,9,2020-2021,27,eng ENG,2 Teams,eng Premier League,16,1421,15.8,16,0,4,9,4,13,8,1,2,1,FWMF,810e3c74,Rotational Player
505,Ayoze Pérez,9,2023-2024,30,es ESP,Betis,es La Liga,31,2294,25.5,29,2,1,9,1,10,9,0,0,0,FW,819aa8e7,Rotational Player
506,Gerard Moreno,9,2021-2022,29,es ESP,Villarreal,es La Liga,17,1191,13.2,14,3,1,9,3,12,8,1,2,1,FW,81f0781e,Rotational Player
507,Arkadiusz Milik,9,2020-2021,26,pl POL,Marseille,fr Ligue 1,15,1220,13.6,14,1,0,9,1,10,6,3,3,0,FW,85613cf0,Rotational Player
508,Gerson,9,2021-2022,24,br BRA,Marseille,fr Ligue 1,35,2544,28.3,29,6,1,9,4,13,9,0,0,0,MFFW,8827bf46,Full Starter
509,Riyad Mahrez,9,2020-2021,29,dz ALG,Manchester City,eng Premier League,27,1949,21.7,23,4,10,9,6,15,9,0,0,0,FW,892d5bb1,Rotational Player
510,Dries Mertens,9,2020-2021,33,be BEL,Napoli,it Serie A,29,1459,16.2,18,11,0,9,8,17,9,0,0,0,FWMF,89b2c8a9,Rotational Player
511,Pascal Groß,9,2022-2023,31,de GER,Brighton,eng Premier League,37,3239,36.0,37,0,0,9,8,17,9,0,0,0,MFDF,8aec0537,Full Starter
512,Mikel Oyarzabal,9,2021-2022,24,es ESP,Real Sociedad,es La Liga,22,1671,18.6,19,3,0,9,3,12,5,4,5,1,FWMF,8c3c640c,Rotational Player
513,Mikel Oyarzabal,9,2023-2024,26,es ESP,Real Sociedad,es La Liga,33,2156,24.0,23,10,1,9,3,12,7,2,2,0,FWMF,8c3c640c,Rotational Player
514,Michael Gregoritsch,9,2021-2022,27,at AUT,Augsburg,de Bundesliga,25,1392,15.5,15,10,6,9,0,9,8,1,1,0,FWMF,8e235926,Rotational Player
515,Rodrygo,9,2022-2023,21,br BRA,Real Madrid,es La Liga,34,2379,26.4,25,9,0,9,8,17,8,1,1,0,FWMF,8f5e92a6,Rotational Player
516,Serhou Guirassy,9,2021-2022,25,gn GUI,Rennes,fr Ligue 1,37,1016,11.3,7,30,1,9,0,9,9,0,0,0,FW,923f4dda,Rotational Player
517,Lucas Paquetá,9,2021-2022,23,br BRA,Lyon,fr Ligue 1,35,2699,30.0,32,3,1,9,6,15,8,1,1,0,MFFW,9b6f7fd5,Full Starter
518,Lucas Paquetá,9,2020-2021,22,br BRA,2 Teams,2 Comps,30,2275,25.3,27,3,3,9,5,14,9,0,0,0,FWMF,9b6f7fd5,Full Starter
519,Nicolas Jackson,9,2024-2025,23,sn SEN,Chelsea,eng Premier League,22,1685,18.7,21,1,1,9,5,14,9,0,0,0,FW,9c36ed83,Rotational Player
520,Roberto Soriano,9,2020-2021,29,it ITA,Bologna,it Serie A,37,3250,36.1,37,0,0,9,6,15,9,0,0,0,MF,9d4c45d6,Full Starter
521,Roberto Soldado,9,2020-2021,35,es ESP,Granada,es La Liga,29,1438,16.0,16,13,1,9,0,9,7,2,2,0,FW,9d66fbe3,Rotational Player
522,Thomas Henry,9,2021-2022,26,fr FRA,Venezia,it Serie A,33,2115,23.5,23,10,0,9,2,11,9,0,0,0,FW,9ef42479,Rotational Player
523,Felipe Anderson,9,2022-2023,29,br BRA,Lazio,it Serie A,38,2958,32.9,35,3,0,9,2,11,9,0,0,0,FW,9f1893b9,Full Starter
524,Julian Brandt,9,2021-2022,25,de GER,Dortmund,de Bundesliga,31,2078,23.1,22,9,0,9,8,17,9,0,0,0,MFFW,a167537f,Rotational Player
525,Julian Brandt,9,2022-2023,26,de GER,Dortmund,de Bundesliga,32,2397,26.6,29,3,0,9,8,17,9,0,0,0,MFFW,a167537f,Rotational Player
526,Ihlas Bebou,9,2020-2021,26,tg TOG,Hoffenheim,de Bundesliga,32,2200,24.4,23,9,2,9,7,16,9,0,0,0,FWMF,a53b661f,Rotational Player
527,Rodrigo Muniz,9,2023-2024,22,br BRA,Fulham,eng Premier League,26,1593,17.7,18,8,7,9,1,10,9,0,0,0,FW,a755db8c,Rotational Player
528,Moussa Diaby,9,2022-2023,23,fr FRA,Leverkusen,de Bundesliga,33,2699,30.0,33,0,0,9,8,17,9,0,1,1,FWMF,aeed5c06,Full Starter
529,Federico Chiesa,9,2020-2021,22,it ITA,2 Teams,it Serie A,33,2450,27.2,31,2,1,9,9,18,9,0,0,0,DF,b0f7e36c,Full Starter
530,Federico Chiesa,9,2023-2024,25,it ITA,Juventus,it Serie A,33,2197,24.4,25,8,0,9,2,11,8,1,1,0,FW,b0f7e36c,Full Starter
531,Gabriel Jesus,9,2020-2021,23,br BRA,Manchester City,eng Premier League,29,2063,22.9,22,7,1,9,4,13,9,0,0,0,FW,b66315ae,Rotational Player
532,Evann Guessand,9,2024-2025,23,ci CIV,Nice,fr Ligue 1,19,1634,18.2,19,0,0,9,5,14,9,0,0,0,FWMF,b73f17f8,Rotational Player
533,Sébastien Haller,9,2022-2023,28,ci CIV,Dortmund,de Bundesliga,19,1225,13.6,15,4,0,9,3,12,9,0,1,1,FW,ba115a40,Rotational Player
534,Maxwel Cornet,9,2021-2022,24,ci CIV,2 Teams,2 Comps,27,1829,20.3,22,5,2,9,1,10,9,0,1,1,DF,beb391dd,Rotational Player
535,Randal Kolo Muani,9,2020-2021,21,fr FRA,Nantes,fr Ligue 1,37,3029,33.7,35,2,0,9,4,13,9,0,0,0,FW,c0b3669f,Rotational Player
536,Callum Wilson,9,2023-2024,31,eng ENG,Newcastle Utd,eng Premier League,20,991,11.0,9,11,0,9,1,10,7,2,2,0,FW,c596fcb0,Rotational Player
537,Brais Méndez,9,2020-2021,23,es ESP,Celta Vigo,es La Liga,34,2671,29.7,30,4,3,9,0,9,8,1,1,0,MFFW,c9e39d91,Full Starter
538,Mattia Destro,9,2021-2022,30,it ITA,Genoa,it Serie A,27,1744,19.4,21,6,3,9,1,10,9,0,0,0,FW,d7d32194,Rotational Player
539,Samu Omorodion,9,2023-2024,19,es ESP,2 Teams,es La Liga,35,1998,22.2,22,13,1,9,1,10,9,0,0,0,FW,dc44b03c,Rotational Player
540,Florian Wirtz,9,2024-2025,21,de GER,Leverkusen,de Bundesliga,19,1487,16.5,16,3,0,9,9,18,7,2,4,2,MF,e7fcf289,Rotational Player
541,João Pedro,9,2023-2024,21,br BRA,Brighton,eng Premier League,31,2045,22.7,19,12,0,9,3,12,5,4,5,1,FWMF,e8832875,Rotational Player
542,Luis Muriel,9,2021-2022,30,co COL,Atalanta,it Serie A,27,1539,17.1,17,10,4,9,8,17,7,2,2,0,FWMF,eb2fe5b6,Rotational Player
543,Mergim Berisha,9,2022-2023,24,de GER,Augsburg,de Bundesliga,23,1679,18.7,20,3,0,9,4,13,6,3,4,1,FW,eb6e14be,Rotational Player
544,Phil Foden,9,2021-2022,21,eng ENG,Manchester City,eng Premier League,28,2128,23.6,24,4,5,9,5,14,9,0,0,0,FW,ed1e53f3,Rotational Player
545,Phil Foden,9,2020-2021,20,eng ENG,Manchester City,eng Premier League,28,1616,18.0,17,11,10,9,5,14,9,0,0,0,FWMF,ed1e53f3,Rotational Player
546,Che Adams,9,2020-2021,24,sct SCO,Southampton,eng Premier League,36,2667,29.6,30,6,0,9,5,14,9,0,0,0,FW,f2bf1b0f,Rotational Player
547,Junior Messias,9,2020-2021,29,br BRA,Crotone,it Serie A,36,3215,35.7,36,0,0,9,4,13,9,0,0,0,MFFW,f49c4ae9,Rotational Player
548,Lautaro Martínez,9,2024-2025,26,ar ARG,Inter,it Serie A,19,1538,17.1,19,0,0,9,3,12,9,0,0,0,FW,f7036e1c,Full Starter
549,Takumi Minamino,9,2023-2024,28,jp JPN,Monaco,fr Ligue 1,30,2117,23.5,25,5,0,9,6,15,9,0,0,0,MF,f833a830,Rotational Player
550,Sávio,9,2023-2024,19,br BRA,Girona,es La Liga,37,2976,33.1,35,2,0,9,10,19,9,0,0,0,FWMF,fe6e7156,Full Starter
551,Kingsley Coman,8,2022-2023,26,fr FRA,Bayern Munich,de Bundesliga,24,1409,15.7,16,8,3,8,5,13,8,0,0,0,FWMF,042e8a49,Rotational Player
552,Youssef En-Nesyri,8,2022-2023,25,ma MAR,Sevilla,es La Liga,31,1661,18.5,17,14,6,8,1,9,8,0,0,0,FW,04e17fd5,Rotational Player
553,Jonathan Burkardt,8,2023-2024,23,de GER,Mainz 05,de Bundesliga,21,1538,17.1,18,3,0,8,2,10,7,1,1,0,FWMF,05f99a4a,Rotational Player
554,Terem Moffi,8,2021-2022,22,ng NGA,Lorient,fr Ligue 1,37,2711,30.1,34,3,0,8,4,12,6,2,2,0,FW,065dc209,Full Starter
555,Danny Ings,8,2022-2023,30,eng ENG,2 Teams,eng Premier League,35,1599,17.8,15,20,3,8,2,10,6,2,2,0,FW,07802f7f,Rotational Player
556,Antonio Sanabria,8,2020-2021,24,py PAR,2 Teams,2 Comps,30,1910,21.2,22,8,4,8,1,9,8,0,0,0,FW,0a447501,Rotational Player
557,Romain Del Castillo,8,2023-2024,27,fr FRA,Brest,fr Ligue 1,33,2497,27.7,30,3,0,8,8,16,5,3,3,0,FW,0be95d34,Rotational Player
558,Lukas Nmecha,8,2021-2022,22,de GER,Wolfsburg,de Bundesliga,25,1627,18.1,18,7,0,8,0,8,8,0,0,0,FWMF,0cc5f4a5,Bench Player
559,Brennan Johnson,8,2022-2023,21,wls WAL,Nott'ham Forest,eng Premier League,38,2934,32.6,33,5,0,8,3,11,7,1,3,2,FWMF,0cd31129,Rotational Player
560,Chris Führich,8,2023-2024,25,de GER,Stuttgart,de Bundesliga,34,2567,28.5,33,1,0,8,7,15,8,0,1,1,FWMF,0cf778df,Rotational Player
561,Callum Hudson-Odoi,8,2023-2024,22,eng ENG,Nott'ham Forest,eng Premier League,29,1854,20.6,20,9,1,8,1,9,8,0,0,0,FWMF,15f3ec41,Rotational Player
562,Cody Gakpo,8,2023-2024,24,nl NED,Liverpool,eng Premier League,35,1649,18.3,17,18,0,8,5,13,8,0,0,0,FWMF,1971591f,Rotational Player
563,Cody Gakpo,8,2024-2025,25,nl NED,Liverpool,eng Premier League,22,1233,13.7,14,8,0,8,3,11,8,0,0,0,FW,1971591f,Rotational Player
564,Portu,8,2020-2021,28,es ESP,Real Sociedad,es La Liga,37,2184,24.3,24,13,1,8,3,11,8,0,0,0,FWMF,1bda5842,Rotational Player
565,Jonas Wind,8,2024-2025,25,dk DEN,Wolfsburg,de Bundesliga,17,933,10.4,9,8,2,8,3,11,7,1,2,1,FWMF,2077ae86,Rotational Player
566,Ezequiel Ávila,8,2022-2023,28,ar ARG,Osasuna,es La Liga,29,1709,19.0,23,6,3,8,2,10,6,2,3,1,FWMF,253a06b9,Rotational Player
567,Elba Rashani,8,2021-2022,28,xk KVX,Clermont Foot,fr Ligue 1,29,1759,19.5,22,7,0,8,3,11,8,0,0,0,FWMF,25749008,Rotational Player
568,Leroy Sané,8,2022-2023,26,de GER,Bayern Munich,de Bundesliga,32,2010,22.3,20,12,0,8,7,15,8,0,0,0,MFFW,2b114be3,Rotational Player
569,Leroy Sané,8,2023-2024,27,de GER,Bayern Munich,de Bundesliga,27,2137,23.7,25,2,0,8,11,19,8,0,0,0,FW,2b114be3,Rotational Player
570,Florian Thauvin,8,2020-2021,27,fr FRA,Marseille,fr Ligue 1,36,2732,30.4,33,3,0,8,8,16,8,0,2,2,FWMF,2b9fdeea,Rotational Player
571,Akor Adams,8,2023-2024,23,ng NGA,Montpellier,fr Ligue 1,32,2252,25.0,27,5,1,8,1,9,8,0,0,0,FW,2ccd39ed,Rotational Player
572,Armand Lauriente,8,2022-2023,23,fr FRA,2 Teams,2 Comps,31,2441,27.1,30,1,0,8,6,14,7,1,1,0,FW,2d22cea7,Full Starter
573,Gianluca Lapadula,8,2020-2021,30,pe PER,Benevento,it Serie A,37,2563,28.5,29,8,1,8,2,10,8,0,1,1,FW,2ead2809,Rotational Player
574,Stephy Mavididi,8,2021-2022,23,eng ENG,Montpellier,fr Ligue 1,30,2299,25.5,27,3,1,8,3,11,8,0,0,0,FWMF,30144daa,Rotational Player
575,Kevin Behrens,8,2022-2023,31,de GER,Union Berlin,de Bundesliga,33,1535,17.1,17,16,0,8,1,9,8,0,0,0,FW,30ae134d,Rotational Player
576,Benjamin Šeško,8,2024-2025,21,si SVN,RB Leipzig,de Bundesliga,18,1278,14.2,17,1,0,8,2,10,8,0,0,0,FWMF,3260690c,Rotational Player
577,Sergi Guardiola,8,2021-2022,30,es ESP,Rayo Vallecano,es La Liga,32,1710,19.0,20,12,3,8,2,10,7,1,1,0,FW,32974271,Rotational Player
578,Pere Milla,8,2021-2022,28,es ESP,Elche,es La Liga,32,1644,18.3,17,15,5,8,3,11,8,0,0,0,MFFW,335039a2,Rotational Player
579,Phillip Tietz,8,2023-2024,26,de GER,Augsburg,de Bundesliga,34,2382,26.5,31,3,0,8,4,12,8,0,0,0,FW,3397e7b5,Rotational Player
580,James Ward-Prowse,8,2020-2021,25,eng ENG,Southampton,eng Premier League,38,3420,38.0,38,0,0,8,7,15,5,3,4,1,MF,3515d404,Full Starter
581,Marco Reus,8,2020-2021,31,de GER,Dortmund,de Bundesliga,32,2279,25.3,27,5,1,8,6,14,8,0,2,2,MFFW,36a3ff67,Rotational Player
582,Aleksandr Golovin,8,2022-2023,26,ru RUS,Monaco,fr Ligue 1,34,2464,27.4,29,5,0,8,7,15,8,0,0,0,MFFW,3708e9fa,Rotational Player
583,Leandro Trossard,8,2022-2023,27,be BEL,2 Teams,eng Premier League,36,2246,25.0,26,10,1,8,12,20,8,0,0,0,FW,38ceb24a,Rotational Player
584,Leandro Trossard,8,2021-2022,26,be BEL,Brighton,eng Premier League,34,2805,31.2,32,2,1,8,3,11,7,1,1,0,FWMF,38ceb24a,Rotational Player
585,Thomas Müller,8,2021-2022,31,de GER,Bayern Munich,de Bundesliga,32,2558,28.4,32,0,0,8,18,26,8,0,0,0,MF,3c6089ab,Full Starter
586,Bernardo Silva,8,2021-2022,26,pt POR,Manchester City,eng Premier League,35,2857,31.7,33,2,3,8,4,12,8,0,0,0,MFFW,3eb22ec9,Full Starter
587,Brahim Díaz,8,2023-2024,23,ma MAR,Real Madrid,es La Liga,31,1545,17.2,18,13,7,8,6,14,8,0,0,0,FWMF,407feb71,Rotational Player
588,Jorge Molina,8,2020-2021,38,es ESP,Granada,es La Liga,33,1615,17.9,17,16,5,8,2,10,8,0,1,1,FW,43f71e77,Rotational Player
589,Joaquín Correa,8,2020-2021,25,ar ARG,Lazio,it Serie A,28,1933,21.5,25,3,4,8,3,11,7,1,1,0,FW,45b9b619,Rotational Player
590,Ruslan Malinovskyi,8,2020-2021,27,ua UKR,Atalanta,it Serie A,36,1876,20.8,22,14,0,8,12,20,7,1,1,0,MFFW,48d5bd33,Rotational Player
591,Luis Díaz,8,2023-2024,26,co COL,Liverpool,eng Premier League,37,2629,29.2,32,5,0,8,5,13,8,0,0,0,FW,4a1a9578,Rotational Player
592,Luis Díaz,8,2024-2025,27,co COL,Liverpool,eng Premier League,21,1339,14.9,16,5,1,8,2,10,8,0,0,0,FW,4a1a9578,Rotational Player
593,Lorenzo Pellegrini,8,2023-2024,27,it ITA,Roma,it Serie A,29,1859,20.7,20,9,2,8,3,11,7,1,1,0,MF,4a5a45c7,Full Starter
594,Neal Maupay,8,2021-2022,24,fr FRA,Brighton,eng Premier League,32,2276,25.3,25,7,5,8,2,10,7,1,2,1,FW,4bcf39f6,Rotational Player
595,Neal Maupay,8,2020-2021,23,fr FRA,Brighton,eng Premier League,33,2512,27.9,29,4,1,8,2,10,5,3,4,1,FWMF,4bcf39f6,Rotational Player
596,Zlatan Ibrahimović,8,2021-2022,39,se SWE,Milan,it Serie A,23,1016,11.3,11,12,2,8,2,10,8,0,1,1,FW,4cde5509,Rotational Player
597,Sergej Milinković-Savić,8,2020-2021,25,rs SRB,Lazio,it Serie A,32,2746,30.5,32,0,1,8,9,17,8,0,0,0,MF,4e6dbac4,Full Starter
598,Bruno Fernandes,8,2022-2023,27,pt POR,Manchester Utd,eng Premier League,37,3316,36.8,37,0,0,8,8,16,6,2,2,0,MFFW,507c7bdf,Full Starter
599,Jean-Philippe Mateta,8,2020-2021,23,fr FRA,2 Teams,2 Comps,22,1218,13.5,14,8,12,8,1,9,7,1,1,0,FW,50e6dc35,Rotational Player
600,Jean-Philippe Mateta,8,2024-2025,27,fr FRA,Crystal Palace,eng Premier League,23,1772,19.7,21,2,0,8,1,9,6,2,2,0,FW,50e6dc35,Rotational Player
601,Seko Fofana,8,2021-2022,26,ci CIV,Lens,fr Ligue 1,38,3357,37.3,38,0,0,8,1,9,8,0,0,0,MF,5313ed43,Full Starter
602,Vincenzo Grifo,8,2023-2024,30,it ITA,Freiburg,de Bundesliga,32,2325,25.8,29,3,2,8,8,16,2,6,6,0,MFFW,54e4866f,Full Starter
603,Hamed Junior Traorè,8,2024-2025,24,ci CIV,2 Teams,2 Comps,16,1335,14.8,16,0,1,8,1,9,8,0,0,0,FWMF,570bb4b9,Rotational Player
604,Jan-Niklas Beste,8,2023-2024,24,de GER,Heidenheim,de Bundesliga,31,2603,28.9,31,0,0,8,11,19,8,0,1,1,FWMF,57382429,Full Starter
605,Eldor Shomurodov,8,2020-2021,25,uz UZB,Genoa,it Serie A,31,1677,18.6,16,15,1,8,1,9,8,0,0,0,FW,57469b2d,Rotational Player
606,Jude Bellingham,8,2022-2023,19,eng ENG,Dortmund,de Bundesliga,31,2691,29.9,30,1,1,8,4,12,7,1,1,0,MF,57d88cf9,Full Starter
607,Mason Greenwood,8,2023-2024,21,eng ENG,Getafe,es La Liga,33,2662,29.6,30,3,0,8,6,14,6,2,3,1,MFFW,58eee997,Rotational Player
608,Mostafa Mohamed,8,2023-2024,25,eg EGY,Nantes,fr Ligue 1,29,2002,22.2,24,5,0,8,2,10,5,3,3,0,FW,595e6f3e,Rotational Player
609,Mostafa Mohamed,8,2022-2023,24,eg EGY,Nantes,fr Ligue 1,36,1939,21.5,18,18,1,8,2,10,8,0,0,0,FW,595e6f3e,Rotational Player
610,Saïd Benrahma,8,2021-2022,25,dz ALG,West Ham,eng Premier League,32,2168,24.1,26,6,1,8,6,14,8,0,0,0,FWMF,5a04fd92,Rotational Player
611,Artem Dovbyk,8,2024-2025,27,ua UKR,Roma,it Serie A,20,1651,18.3,19,1,0,8,2,10,6,2,2,0,FW,5b847bb0,Full Starter
612,Irvin Cardona,8,2020-2021,22,fr FRA,Brest,fr Ligue 1,36,2029,22.5,22,14,2,8,1,9,8,0,0,0,FW,5e080f73,Rotational Player
613,Matteo Politano,8,2023-2024,29,it ITA,Napoli,it Serie A,37,2360,26.2,31,6,0,8,7,15,6,2,3,1,FW,5e861944,Rotational Player
614,Romelu Lukaku,8,2021-2022,28,be BEL,Chelsea,eng Premier League,26,1589,17.7,16,10,3,8,0,8,7,1,1,0,FW,5eae500a,Rotational Player
615,Álvaro Negredo,8,2020-2021,34,es ESP,Cádiz,es La Liga,35,2198,24.4,29,6,0,8,4,12,8,0,0,0,FW,63b0ca6b,Full Starter
616,Masaya Okugawa,8,2021-2022,25,jp JPN,Arminia,de Bundesliga,33,2531,28.1,30,3,1,8,1,9,8,0,0,0,MFFW,63b9cc6d,Full Starter
617,Rodri,8,2023-2024,27,es ESP,Manchester City,eng Premier League,34,2931,32.6,34,0,1,8,9,17,8,0,0,0,MF,6434f10d,Full Starter
618,Andrea Colpani,8,2023-2024,24,it ITA,Monza,it Serie A,38,2657,29.5,36,2,0,8,4,12,8,0,0,0,MFFW,6499048c,Rotational Player
619,Borja Mayoral,8,2022-2023,25,es ESP,Getafe,es La Liga,35,2759,30.7,33,2,3,8,2,10,8,0,2,2,FW,64e8ed6d,Rotational Player
620,Tim Skarke,8,2023-2024,26,de GER,Darmstadt 98,de Bundesliga,30,2404,26.7,29,1,0,8,0,8,8,0,0,0,FWDF,65857fdf,Full Starter
621,Mohamed Amoura,8,2024-2025,24,dz ALG,Wolfsburg,de Bundesliga,17,1381,15.3,16,1,0,8,6,14,8,0,0,0,FW,6597f8b6,Rotational Player
622,Stuart Dallas,8,2020-2021,29,nir NIR,Leeds United,eng Premier League,38,3409,37.9,38,0,0,8,2,10,8,0,0,0,MFDF,67ca8566,Full Starter
623,Iñaki Williams,8,2021-2022,27,gh GHA,Athletic Club,es La Liga,38,2777,30.9,32,6,0,8,5,13,7,1,1,0,FW,6a99e0b1,Full Starter
624,Téji Savanier,8,2021-2022,29,fr FRA,Montpellier,fr Ligue 1,29,2414,26.8,28,1,0,8,7,15,5,3,4,1,MF,6bde367b,Full Starter
625,Marcus Thuram,8,2020-2021,22,fr FRA,Gladbach,de Bundesliga,29,1731,19.2,20,9,0,8,3,11,8,0,0,0,FWMF,6f8cd6d0,Rotational Player
626,Ivan Perišić,8,2021-2022,32,hr CRO,Inter,it Serie A,35,2821,31.3,35,0,2,8,6,14,7,1,1,0,DF,6fe90922,Full Starter
627,Vinicius Júnior,8,2024-2025,24,br BRA,Real Madrid,es La Liga,15,1175,13.1,13,2,0,8,5,13,6,2,2,0,FW,7111d552,Rotational Player
628,Jeremie Frimpong,8,2022-2023,21,nl NED,Leverkusen,de Bundesliga,34,2708,30.1,32,2,0,8,7,15,8,0,0,0,DFMF,74f2e748,Full Starter
629,Martin Ødegaard,8,2023-2024,24,no NOR,Arsenal,eng Premier League,35,3091,34.3,35,0,1,8,10,18,6,2,2,0,MF,79300479,Full Starter
630,Jarrod Bowen,8,2020-2021,23,eng ENG,West Ham,eng Premier League,38,2562,28.5,30,8,0,8,5,13,8,0,0,0,FWMF,79c84d1c,Full Starter
631,Florian Sotoca,8,2020-2021,29,fr FRA,Lens,fr Ligue 1,33,2413,26.8,28,5,1,8,3,11,6,2,2,0,FW,7a42d0df,Full Starter
632,Lars Stindl,8,2022-2023,33,de GER,Gladbach,de Bundesliga,29,1734,19.3,20,9,2,8,7,15,8,0,0,0,FWMF,7cd6badb,Rotational Player
633,Sebastiano Esposito,8,2024-2025,22,it ITA,Empoli,it Serie A,18,1209,13.4,13,5,0,8,0,8,7,1,2,1,FWMF,7ff93107,Rotational Player
634,Ayoze Pérez,8,2024-2025,31,es ESP,Villarreal,es La Liga,14,772,8.6,7,7,0,8,0,8,8,0,0,0,FW,819aa8e7,Rotational Player
635,İlkay Gündoğan,8,2022-2023,31,de GER,Manchester City,eng Premier League,31,2353,26.1,27,4,7,8,4,12,8,0,1,1,MF,819b3158,Full Starter
636,İlkay Gündoğan,8,2021-2022,30,de GER,Manchester City,eng Premier League,27,1857,20.6,20,7,8,8,4,12,8,0,0,0,MF,819b3158,Full Starter
637,Lorenzo Lucca,8,2024-2025,23,it ITA,Udinese,it Serie A,21,1415,15.7,16,5,0,8,0,8,8,0,0,0,FW,83c06f3a,Rotational Player
638,Lorenzo Lucca,8,2023-2024,22,it ITA,Udinese,it Serie A,37,2592,28.8,30,7,0,8,4,12,8,0,0,0,FW,83c06f3a,Rotational Player
639,Philipp Hofmann,8,2022-2023,29,de GER,Bochum,de Bundesliga,34,2631,29.2,31,3,0,8,2,10,8,0,0,0,FW,877bc844,Rotational Player
640,Gianluca Scamacca,8,2020-2021,21,it ITA,2 Teams,it Serie A,26,1352,15.0,13,13,6,8,2,10,6,2,2,0,FW,8790f988,Rotational Player
641,Adrien Rabiot,8,2022-2023,27,fr FRA,Juventus,it Serie A,32,2748,30.5,31,1,0,8,4,12,8,0,0,0,MF,8794e251,Full Starter
642,João Félix,8,2022-2023,22,pt POR,2 Teams,2 Comps,30,1591,17.7,18,12,2,8,3,11,8,0,0,0,FWMF,8aafd64f,Rotational Player
643,João Félix,8,2021-2022,21,pt POR,Atlético Madrid,es La Liga,24,1263,14.0,13,11,0,8,4,12,8,0,0,0,FWMF,8aafd64f,Rotational Player
644,Ante Budimir,8,2021-2022,30,hr CRO,Osasuna,es La Liga,28,1738,19.3,20,8,2,8,2,10,6,2,2,0,FW,8f3565b3,Rotational Player
645,Ante Budimir,8,2022-2023,31,hr CRO,Osasuna,es La Liga,31,1798,20.0,22,9,6,8,0,8,8,0,0,0,FW,8f3565b3,Rotational Player
646,Serhou Guirassy,8,2024-2025,28,gn GUI,Dortmund,de Bundesliga,16,1421,15.8,16,0,0,8,1,9,6,2,2,0,FW,923f4dda,Rotational Player
647,Grischa Prömel,8,2021-2022,26,de GER,Union Berlin,de Bundesliga,29,2422,26.9,28,1,0,8,1,9,8,0,0,0,MF,924f9191,Full Starter
648,Felipe Caicedo,8,2020-2021,31,ec ECU,Lazio,it Serie A,25,929,10.3,9,16,5,8,0,8,7,1,1,0,FW,93b891d1,Bench Player
649,Isco,8,2023-2024,31,es ESP,Betis,es La Liga,29,2326,25.8,28,1,0,8,5,13,6,2,2,0,MF,a0b4bb3e,Full Starter
650,Emanuel Emegha,8,2024-2025,21,nl NED,Strasbourg,fr Ligue 1,14,1134,12.6,14,0,0,8,2,10,8,0,0,0,FW,a0c590b9,Rotational Player
651,Emanuel Emegha,8,2023-2024,20,nl NED,Strasbourg,fr Ligue 1,28,2078,23.1,23,5,0,8,1,9,8,0,1,1,FW,a0c590b9,Rotational Player
652,Joe Willock,8,2020-2021,20,eng ENG,2 Teams,eng Premier League,21,1216,13.5,13,8,11,8,0,8,8,0,1,1,MF,a3b03921,Rotational Player
653,Piotr Zieliński,8,2020-2021,26,pl POL,Napoli,it Serie A,36,2523,28.0,32,4,0,8,10,18,8,0,0,0,MF,a5296e55,Full Starter
654,Sergio Canales,8,2020-2021,29,es ESP,Betis,es La Liga,31,2498,27.8,28,3,0,8,6,14,6,2,3,1,MFFW,a6de370d,Full Starter
655,Arthur Cabral,8,2022-2023,24,br BRA,Fiorentina,it Serie A,28,1432,15.9,15,13,6,8,1,9,6,2,2,0,FW,a820e429,Rotational Player
656,Jack Harrison,8,2020-2021,23,eng ENG,Leeds United,eng Premier League,36,2847,31.6,34,2,0,8,8,16,8,0,0,0,MFFW,aa849a12,Full Starter
657,Jack Harrison,8,2021-2022,24,eng ENG,Leeds United,eng Premier League,35,2639,29.3,32,3,2,8,1,9,8,0,0,0,FWMF,aa849a12,Full Starter
658,Gabriel Strefezza,8,2022-2023,25,br BRA,Lecce,it Serie A,35,2442,27.1,30,5,0,8,4,12,6,2,3,1,FWMF,ac4a4508,Full Starter
659,Daniel Ciofani,8,2022-2023,37,it ITA,Cremonese,it Serie A,32,1060,11.8,10,22,4,8,0,8,5,3,4,1,FW,b09a3ecc,Rotational Player
660,Sofiane Boufal,8,2021-2022,27,ma MAR,Angers,fr Ligue 1,29,2330,25.9,28,1,0,8,4,12,5,3,3,0,FWMF,b0c71810,Rotational Player
661,Raheem Sterling,8,2023-2024,28,eng ENG,Chelsea,eng Premier League,31,1978,22.0,22,9,3,8,4,12,8,0,0,0,FWMF,b400bde0,Rotational Player
662,Raúl Jiménez,8,2024-2025,33,mx MEX,Fulham,eng Premier League,23,1450,16.1,18,5,0,8,2,10,5,3,3,0,FW,b561db50,Rotational Player
663,Mohammed Kudus,8,2023-2024,22,gh GHA,West Ham,eng Premier League,33,2484,27.6,27,6,0,8,6,14,8,0,0,0,FWMF,b62878a5,Rotational Player
664,Gabriel Jesus,8,2021-2022,24,br BRA,Manchester City,eng Premier League,28,1877,20.9,21,7,6,8,8,16,7,1,1,0,FW,b66315ae,Rotational Player
665,Roland Sallai,8,2020-2021,23,hu HUN,Freiburg,de Bundesliga,28,1661,18.5,22,6,0,8,3,11,7,1,1,0,MFFW,bf075f6b,Rotational Player
666,Arnaud Kalimuendo,8,2024-2025,22,fr FRA,Rennes,fr Ligue 1,18,1401,15.6,17,1,0,8,0,8,4,4,5,1,FW,bf4c41f9,Rotational Player
667,Fermin López,8,2023-2024,20,es ESP,Barcelona,es La Liga,31,1446,16.1,14,17,6,8,0,8,8,0,0,0,MFFW,c1fe5f0b,Rotational Player
668,Conor Gallagher,8,2021-2022,21,eng ENG,Crystal Palace,eng Premier League,34,2845,31.6,33,1,0,8,3,11,8,0,0,0,MF,c2731c10,Full Starter
669,Wout Weghorst,8,2021-2022,28,nl NED,2 Teams,2 Comps,38,3003,33.4,34,4,0,8,4,12,7,1,2,1,FW,c4e87b8b,Full Starter
670,Callum Wilson,8,2021-2022,29,eng ENG,Newcastle Utd,eng Premier League,18,1386,15.4,16,2,0,8,0,8,6,2,2,0,FW,c596fcb0,Rotational Player
671,Georginio Rutter,8,2021-2022,19,fr FRA,Hoffenheim,de Bundesliga,33,1611,17.9,13,20,0,8,2,10,8,0,0,0,FWMF,c64c01fc,Rotational Player
672,Rafael Borré,8,2021-2022,25,co COL,Eint Frankfurt,de Bundesliga,31,2378,26.4,28,3,1,8,4,12,8,0,0,0,FW,c68da769,Rotational Player
673,Adrien Thomasson,8,2021-2022,27,fr FRA,Strasbourg,fr Ligue 1,31,2389,26.5,27,4,0,8,4,12,8,0,0,0,MF,c76b7567,Full Starter
674,Brais Méndez,8,2022-2023,25,es ESP,Real Sociedad,es La Liga,34,2407,26.7,28,6,1,8,4,12,8,0,0,0,MF,c9e39d91,Full Starter
675,André Hahn,8,2020-2021,29,de GER,Augsburg,de Bundesliga,29,2037,22.6,24,5,1,8,3,11,8,0,0,0,FWMF,cd82452e,Rotational Player
676,Daniele Verde,8,2021-2022,25,it ITA,Spezia,it Serie A,33,1957,21.7,21,12,2,8,6,14,7,1,2,1,FWMF,d3298c99,Rotational Player
677,Mohamed Bamba,8,2023-2024,21,ci CIV,Lorient,fr Ligue 1,16,1138,12.6,14,2,0,8,3,11,7,1,1,0,FW,d469252b,Rotational Player
678,Andrea Belotti,8,2021-2022,27,it ITA,Torino,it Serie A,22,1371,15.2,16,6,1,8,1,9,5,3,3,0,FW,d705ba44,Rotational Player
679,Willian José,8,2021-2022,29,br BRA,Betis,es La Liga,32,1604,17.8,19,13,2,8,4,12,5,3,3,0,FW,d87e2cae,Rotational Player
680,Keito Nakamura,8,2024-2025,24,jp JPN,Reims,fr Ligue 1,19,1492,16.6,18,1,0,8,1,9,8,0,0,0,FW,d97af612,Rotational Player
681,Giacomo Bonaventura,8,2023-2024,33,it ITA,Fiorentina,it Serie A,31,2277,25.3,27,4,4,8,3,11,8,0,1,1,MF,d995ed27,Full Starter
682,Xavi Simons,8,2023-2024,20,nl NED,RB Leipzig,de Bundesliga,32,2653,29.5,32,0,0,8,11,19,7,1,2,1,MF,da4d670f,Rotational Player
683,Franck Honorat,8,2020-2021,23,fr FRA,Brest,fr Ligue 1,36,2458,27.3,28,8,0,8,4,12,8,0,0,0,MFFW,db7849ca,Full Starter
684,David McGoldrick,8,2020-2021,32,ie IRL,Sheffield Utd,eng Premier League,35,2397,26.6,28,7,2,8,1,9,8,0,0,0,FWMF,dbe56a33,Full Starter
685,Jadon Sancho,8,2020-2021,20,eng ENG,Dortmund,de Bundesliga,26,2062,22.9,24,2,1,8,11,19,7,1,1,0,FWMF,dbf053da,Rotational Player
686,Álex Berenguer,8,2020-2021,25,es ESP,2 Teams,2 Comps,37,2409,26.8,29,8,0,8,4,12,8,0,0,0,MF,dc1c2fce,Rotational Player
687,Liam Delap,8,2024-2025,21,eng ENG,Ipswich Town,eng Premier League,22,1674,18.6,21,1,0,8,2,10,6,2,2,0,FW,dd897ee7,Rotational Player
688,Dejan Kulusevski,8,2023-2024,23,se SWE,Tottenham,eng Premier League,36,2762,30.7,31,5,0,8,3,11,8,0,0,0,FWMF,df3cda47,Rotational Player
689,Marcel Sabitzer,8,2020-2021,26,at AUT,RB Leipzig,de Bundesliga,27,2026,22.5,24,3,2,8,3,11,4,4,4,0,MF,e280527c,Rotational Player
690,Musa Barrow,8,2020-2021,21,gm GAM,Bologna,it Serie A,38,2921,32.5,34,4,0,8,8,16,8,0,1,1,FWMF,e5bf73f3,Full Starter
691,Cyle Larin,8,2022-2023,27,ca CAN,Valladolid,es La Liga,19,1469,16.3,16,3,1,8,3,11,6,2,2,0,FW,e7af9060,Rotational Player
692,Kiké,8,2024-2025,34,es ESP,Alavés,es La Liga,19,1183,13.1,13,6,0,8,0,8,7,1,1,0,FW,e897d8ba,Rotational Player
693,Alexander Sørloth,8,2024-2025,28,no NOR,Atlético Madrid,es La Liga,18,781,8.7,7,11,2,8,2,10,8,0,0,0,FW,e92cd3f7,Rotational Player
694,Ermedin Demirović,8,2022-2023,24,ba BIH,Augsburg,de Bundesliga,30,2366,26.3,30,0,0,8,4,12,7,1,1,0,FWMF,ed79b7d3,Rotational Player
695,Ermedin Demirović,8,2024-2025,26,ba BIH,Stuttgart,de Bundesliga,19,1132,12.6,13,6,0,8,0,8,8,0,2,2,FW,ed79b7d3,Rotational Player
696,James Maddison,8,2020-2021,23,eng ENG,Leicester City,eng Premier League,31,2099,23.3,24,7,0,8,5,13,8,0,0,0,MF,ee38d9c5,Rotational Player
697,James Maddison,8,2024-2025,27,eng ENG,Tottenham,eng Premier League,22,1300,14.4,15,7,0,8,4,12,8,0,0,0,MF,ee38d9c5,Rotational Player
698,Luis Javier Suárez,8,2021-2022,23,co COL,Granada,es La Liga,37,2844,31.6,34,3,0,8,4,12,8,0,1,1,FW,eeba07f8,Rotational Player
699,Antoine Semenyo,8,2023-2024,23,gh GHA,Bournemouth,eng Premier League,33,2105,23.4,25,8,3,8,2,10,8,0,0,0,FW,efd2ec23,Rotational Player
700,Muhammed Cham,8,2023-2024,22,at AUT,Clermont Foot,fr Ligue 1,33,2554,28.4,29,4,0,8,4,12,4,4,5,1,MFFW,f527a32c,Full Starter
701,Tammy Abraham,8,2022-2023,24,eng ENG,Roma,it Serie A,38,2189,24.3,24,14,0,8,3,11,8,0,0,0,FW,f586779e,Rotational Player
702,Viktor Tsyhankov,8,2023-2024,25,ua UKR,Girona,es La Liga,30,2052,22.8,26,4,0,8,7,15,8,0,0,0,MFFW,f7e87032,Rotational Player
703,Nils Petersen,8,2020-2021,31,de GER,Freiburg,de Bundesliga,32,1301,14.5,12,20,1,8,0,8,7,1,1,0,FW,f93e6e94,Bench Player
704,Kai Havertz,8,2021-2022,22,de GER,Chelsea,eng Premier League,29,1809,20.1,22,7,6,8,3,11,8,0,0,0,FWMF,fed7cb61,Rotational Player
705,Kai Havertz,8,2024-2025,25,de GER,Arsenal,eng Premier League,20,1750,19.4,20,0,1,8,2,10,8,0,0,0,FWMF,fed7cb61,Rotational Player
706,Antonín Barák,7,2020-2021,25,cz CZE,Hellas Verona,it Serie A,34,2765,30.7,32,2,0,7,3,10,7,0,0,0,MF,01efac19,Rotational Player
707,Abdoulaye Doucouré,7,2023-2024,30,ml MLI,Everton,eng Premier League,32,2629,29.2,32,0,0,7,1,8,7,0,0,0,FWMF,02b29014,Full Starter
708,Ibrahima Koné,7,2022-2023,23,ml MLI,Lorient,fr Ligue 1,37,1577,17.5,15,22,1,7,1,8,5,2,3,1,FW,04bb2b06,Rotational Player
709,Walid Cheddira,7,2023-2024,25,ma MAR,Frosinone,it Serie A,36,2120,23.6,24,12,1,7,1,8,6,1,1,0,FW,0545a08e,Rotational Player
710,Odsonne Édouard,7,2023-2024,25,fr FRA,Crystal Palace,eng Premier League,30,1555,17.3,17,13,3,7,0,7,7,0,0,0,FWMF,0562b7f1,Rotational Player
711,Danny Ings,7,2021-2022,29,eng ENG,Aston Villa,eng Premier League,30,1898,21.1,22,8,3,7,6,13,6,1,1,0,FW,07802f7f,Rotational Player
712,Phil Harres,7,2024-2025,22,de GER,Holstein Kiel,de Bundesliga,12,913,10.1,11,1,1,7,1,8,7,0,0,0,FW,07db670d,Rotational Player
713,Mattia Aramu,7,2021-2022,26,it ITA,Venezia,it Serie A,32,2100,23.3,25,7,0,7,5,12,4,3,4,1,MFFW,0847b5a5,Rotational Player
714,Federico Valverde,7,2022-2023,24,uy URU,Real Madrid,es La Liga,34,2502,27.8,29,5,4,7,4,11,7,0,0,0,MFFW,0959c2a2,Rotational Player
715,Roger Martí,7,2021-2022,30,es ESP,Levante,es La Liga,29,2115,23.5,25,4,0,7,3,10,6,1,3,2,FW,0ae4e09a,Rotational Player
716,Denis Bouanga,7,2020-2021,25,ga GAB,Saint-Étienne,fr Ligue 1,36,2720,30.2,30,6,0,7,4,11,4,3,4,1,MFFW,0b0cbe5b,Full Starter
717,Santi Mina,7,2021-2022,25,es ESP,Celta Vigo,es La Liga,33,2367,26.3,30,3,0,7,3,10,7,0,1,1,FW,0b90bb97,Full Starter
718,Ansu Fati,7,2022-2023,19,es ESP,Barcelona,es La Liga,36,1393,15.5,12,24,1,7,3,10,7,0,0,0,FW,0ba976e4,Bench Player
719,Vedat Muriqi,7,2023-2024,29,xk KVX,Mallorca,es La Liga,29,2327,25.9,25,4,0,7,2,9,6,1,3,2,FW,0cadc46d,Rotational Player
720,Brennan Johnson,7,2024-2025,23,wls WAL,Tottenham,eng Premier League,21,1492,16.6,16,5,0,7,2,9,7,0,0,0,FW,0cd31129,Rotational Player
721,Philippe Coutinho,7,2021-2022,29,br BRA,2 Teams,2 Comps,31,1832,20.4,21,10,4,7,3,10,6,1,1,0,MFFW,0ef89a37,Rotational Player
722,Jamie Gittens,7,2024-2025,19,eng ENG,Dortmund,de Bundesliga,19,1277,14.2,15,4,0,7,3,10,7,0,0,0,FWMF,10745192,Bench Player
723,Rémy Cabella,7,2022-2023,32,fr FRA,Lille,fr Ligue 1,32,2525,28.1,28,4,1,7,10,17,7,0,0,0,MFFW,148e136f,Rotational Player
724,Takefusa Kubo,7,2023-2024,22,jp JPN,Real Sociedad,es La Liga,30,2150,23.9,24,6,4,7,4,11,7,0,0,0,FWMF,16aa3654,Rotational Player
725,Diogo Jota,7,2022-2023,25,pt POR,Liverpool,eng Premier League,22,1131,12.6,12,10,0,7,4,11,7,0,0,0,FW,178ae8f8,Rotational Player
726,Krzysztof Piątek,7,2020-2021,25,pl POL,Hertha BSC,de Bundesliga,32,1630,18.1,18,14,0,7,1,8,7,0,1,1,FW,17f3620a,Rotational Player
727,Sofiane Diop,7,2020-2021,20,fr FRA,Monaco,fr Ligue 1,32,2023,22.5,24,8,0,7,1,8,7,0,0,0,MFFW,19053e31,Rotational Player
728,Cody Gakpo,7,2022-2023,23,nl NED,Liverpool,eng Premier League,21,1458,16.2,17,4,0,7,2,9,7,0,0,0,FWMF,1971591f,Rotational Player
729,Ansgar Knauff,7,2023-2024,21,de GER,Eint Frankfurt,de Bundesliga,31,2109,23.4,24,7,1,7,2,9,7,0,0,0,MFDF,19a967ab,Rotational Player
730,Portu,7,2023-2024,31,es ESP,2 Teams,es La Liga,36,1285,14.3,11,25,2,7,5,12,7,0,0,0,FW,1bda5842,Rotational Player
731,Declan Rice,7,2023-2024,24,eng ENG,Arsenal,eng Premier League,38,3225,35.8,37,1,0,7,8,15,7,0,0,0,MF,1c7012b8,Full Starter
732,Rodrigo,7,2020-2021,29,es ESP,Leeds United,eng Premier League,26,1288,14.3,14,12,0,7,2,9,7,0,0,0,MFFW,1fb1c435,Rotational Player
733,Jens Stage,7,2024-2025,27,dk DEN,Werder Bremen,de Bundesliga,15,1204,13.4,14,1,1,7,3,10,7,0,0,0,MF,1fffae99,Rotational Player
734,Benjamin Bourigeaud,7,2022-2023,28,fr FRA,Rennes,fr Ligue 1,37,3065,34.1,37,0,0,7,10,17,5,2,2,0,MFFW,20e73fac,Full Starter
735,Nahuel Molina,7,2021-2022,23,ar ARG,Udinese,it Serie A,35,2638,29.3,31,4,0,7,2,9,7,0,0,0,DF,23610943,Full Starter
736,Nicolás González,7,2021-2022,23,ar ARG,Fiorentina,it Serie A,33,2357,26.2,26,7,1,7,6,13,4,3,3,0,FW,2374aaca,Rotational Player
737,Ignatius Ganago,7,2020-2021,21,cm CMR,Lens,fr Ligue 1,24,1304,14.5,16,8,3,7,0,7,7,0,0,0,FW,23c63b7f,Rotational Player
738,Yoane Wissa,7,2022-2023,25,cd COD,Brentford,eng Premier League,38,1606,17.8,16,22,0,7,3,10,7,0,0,0,FW,2500cef9,Rotational Player
739,Yoane Wissa,7,2021-2022,24,cd COD,Brentford,eng Premier League,30,1284,14.3,12,18,3,7,1,8,7,0,0,0,FW,2500cef9,Rotational Player
740,Wahbi Khazri,7,2020-2021,29,tn TUN,Saint-Étienne,fr Ligue 1,22,1181,13.1,16,6,1,7,1,8,4,3,3,0,FW,2677a1de,Rotational Player
741,Javi Puado,7,2022-2023,24,es ESP,Espanyol,es La Liga,37,2340,26.0,25,12,0,7,2,9,7,0,0,0,FWMF,2683eda7,Rotational Player
742,Javi Puado,7,2024-2025,26,es ESP,Espanyol,es La Liga,19,1634,18.2,19,0,0,7,1,8,6,1,1,0,FWMF,2683eda7,Rotational Player
743,José Luis García Vayá,7,2023-2024,24,es ESP,Valencia,es La Liga,37,3302,36.7,37,0,0,7,1,8,0,7,8,1,MF,27dc1378,Full Starter
744,Davide Frattesi,7,2022-2023,22,it ITA,Sassuolo,it Serie A,36,2873,31.9,35,1,1,7,0,7,7,0,0,0,MF,2a7d27c1,Rotational Player
745,Marshall Munetsi,7,2022-2023,26,zw ZIM,Reims,fr Ligue 1,34,2700,30.0,31,3,0,7,3,10,7,0,0,0,MF,2acf0cd7,Rotational Player
746,Leroy Sané,7,2021-2022,25,de GER,Bayern Munich,de Bundesliga,32,1976,22.0,22,10,0,7,7,14,7,0,0,0,FWMF,2b114be3,Rotational Player
747,Cyril Ngonge,7,2023-2024,23,be BEL,2 Teams,it Serie A,32,1746,19.4,18,14,1,7,2,9,7,0,0,0,FWMF,2b8360f1,Rotational Player
748,Alexis Sánchez,7,2020-2021,31,cl CHI,Inter,it Serie A,30,1146,12.7,12,18,2,7,5,12,7,0,1,1,FW,2c0f8e9e,Rotational Player
749,Dango Ouattara,7,2022-2023,20,bf BFA,2 Teams,2 Comps,37,2789,31.0,33,4,0,7,8,15,7,0,0,0,FWMF,2f9e4435,Rotational Player
750,Folarin Balogun,7,2023-2024,22,us USA,Monaco,fr Ligue 1,29,1692,18.8,19,10,0,7,5,12,7,0,3,3,FW,31822f8c,Rotational Player
751,Raphinha,7,2020-2021,23,br BRA,2 Teams,2 Comps,36,2764,30.7,31,5,0,7,11,18,7,0,0,0,MFFW,3423f250,Full Starter
752,Raphinha,7,2022-2023,25,br BRA,Barcelona,es La Liga,36,2072,23.0,25,11,1,7,7,14,7,0,0,0,FW,3423f250,Full Starter
753,Lee Jae-sung,7,2022-2023,29,kr KOR,Mainz 05,de Bundesliga,34,1894,21.0,24,10,0,7,5,12,7,0,0,0,MF,34b0387f,Rotational Player
754,James Ward-Prowse,7,2023-2024,28,eng ENG,West Ham,eng Premier League,37,3001,33.3,34,3,0,7,7,14,5,2,2,0,MF,3515d404,Full Starter
755,Antonio Candreva,7,2022-2023,35,it ITA,Salernitana,it Serie A,35,2726,30.3,32,3,0,7,4,11,7,0,0,0,MFDF,356c9002,Full Starter
756,Antonio Candreva,7,2021-2022,34,it ITA,Sampdoria,it Serie A,36,3119,34.7,36,0,0,7,10,17,6,1,2,1,MFFW,356c9002,Full Starter
757,Jesper Lindstrøm,7,2022-2023,22,dk DEN,Eint Frankfurt,de Bundesliga,27,1679,18.7,22,5,0,7,2,9,7,0,0,0,MFFW,37dc1a48,Rotational Player
758,Hugo Duro,7,2021-2022,21,es ESP,2 Teams,es La Liga,31,1846,20.5,22,9,3,7,1,8,7,0,0,0,DFMF,37e103f8,Rotational Player
759,Hugo Duro,7,2024-2025,24,es ESP,Valencia,es La Liga,18,1474,16.4,17,1,1,7,2,9,7,0,0,0,FW,37e103f8,Rotational Player
760,Anthony Lozano,7,2021-2022,28,hn HON,Cádiz,es La Liga,31,1672,18.6,21,10,2,7,2,9,7,0,0,0,FWMF,38699c72,Rotational Player
761,Gonzalo Melero,7,2020-2021,26,es ESP,Levante,es La Liga,29,1853,20.6,21,8,1,7,1,8,7,0,0,0,MFFW,3902e91b,Rotational Player
762,Gonzalo Melero,7,2021-2022,27,es ESP,Levante,es La Liga,29,1692,18.8,20,9,1,7,2,9,5,2,2,0,MF,3902e91b,Rotational Player
763,Vitinha,7,2023-2024,23,pt POR,Paris S-G,fr Ligue 1,28,2126,23.6,23,5,3,7,4,11,7,0,0,0,MF,3b029691,Rotational Player
764,Edin Džeko,7,2020-2021,34,ba BIH,Roma,it Serie A,27,1824,20.3,20,7,4,7,3,10,7,0,1,1,FW,3bb7f478,Rotational Player
765,Thomas Müller,7,2022-2023,32,de GER,Bayern Munich,de Bundesliga,27,1665,18.5,21,6,0,7,8,15,7,0,0,0,FWMF,3c6089ab,Full Starter
766,Bamba Dieng,7,2021-2022,21,sn SEN,Marseille,fr Ligue 1,25,975,10.8,11,14,4,7,1,8,6,1,1,0,FW,40774c6b,Bench Player
767,Jhon Durán,7,2024-2025,20,co COL,Aston Villa,eng Premier League,20,638,7.1,4,16,1,7,0,7,7,0,0,0,FW,414184f7,Bench Player
768,Christoph Baumgartner,7,2022-2023,22,at AUT,Hoffenheim,de Bundesliga,33,2567,28.5,33,0,0,7,3,10,7,0,0,0,MFFW,437f2b00,Rotational Player
769,Christoph Baumgartner,7,2021-2022,21,at AUT,Hoffenheim,de Bundesliga,29,1888,21.0,23,6,0,7,2,9,7,0,0,0,MFFW,437f2b00,Rotational Player
770,Mauro Icardi,7,2020-2021,27,ar ARG,Paris S-G,fr Ligue 1,20,1079,12.0,11,9,1,7,3,10,6,1,1,0,FW,43b78598,Rotational Player
771,Ciro Immobile,7,2023-2024,33,it ITA,Lazio,it Serie A,31,1652,18.4,21,10,1,7,1,8,3,4,4,0,FW,4431aed2,Full Starter
772,Jamie Vardy,7,2024-2025,37,eng ENG,Leicester City,eng Premier League,21,1717,19.1,21,0,0,7,3,10,6,1,1,0,FW,45963054,Rotational Player
773,Jorginho,7,2020-2021,28,it ITA,Chelsea,eng Premier League,28,2010,22.3,23,5,10,7,1,8,0,7,9,2,MF,45db685d,Rotational Player
774,Ludovic Ajorque,7,2024-2025,30,fr FRA,Brest,fr Ligue 1,17,1303,14.5,15,2,0,7,1,8,7,0,1,1,FW,462475ed,Full Starter
775,Ludovic Ajorque,7,2022-2023,28,fr FRA,2 Teams,2 Comps,30,1982,22.0,24,6,1,7,1,8,6,1,1,0,FW,462475ed,Full Starter
776,Nikola Krstović,7,2023-2024,23,me MNE,Lecce,it Serie A,35,2373,26.4,30,5,1,7,1,8,6,1,3,2,FW,473803c9,Full Starter
777,El Bilal Touré,7,2022-2023,20,ml MLI,2 Teams,2 Comps,24,1355,15.1,16,8,5,7,2,9,7,0,0,0,FW,47c609d5,Rotational Player
778,José Luis Morales,7,2023-2024,36,es ESP,Villarreal,es La Liga,29,1048,11.6,8,21,9,7,0,7,7,0,0,0,FWMF,4a478107,Rotational Player
779,José Luis Morales,7,2022-2023,35,es ESP,Villarreal,es La Liga,29,1211,13.5,11,18,1,7,0,7,7,0,0,0,FWMF,4a478107,Rotational Player
780,Lorenzo Pellegrini,7,2020-2021,24,it ITA,Roma,it Serie A,34,2598,28.9,30,4,0,7,6,13,6,1,1,0,MF,4a5a45c7,Full Starter
781,Angelo Fulgini,7,2020-2021,23,fr FRA,Angers,fr Ligue 1,33,2725,30.3,33,0,0,7,3,10,6,1,1,0,MF,4b96c347,Full Starter
782,Maxi Gómez,7,2020-2021,23,uy URU,Valencia,es La Liga,31,2689,29.9,31,0,1,7,1,8,7,0,0,0,FW,4c2e9442,Full Starter
783,Justin Kluivert,7,2023-2024,24,nl NED,Bournemouth,eng Premier League,32,1916,21.3,26,6,6,7,1,8,7,0,0,0,MFFW,4c3a6744,Rotational Player
784,Keita Baldé,7,2020-2021,25,sn SEN,Sampdoria,it Serie A,25,1197,13.3,12,13,3,7,1,8,7,0,0,0,FW,509a4ccb,Rotational Player
785,Martin Terrier,7,2023-2024,26,fr FRA,Rennes,fr Ligue 1,24,1527,17.0,19,5,0,7,3,10,7,0,0,0,FWMF,5148dcc5,Full Starter
786,Thierno Barry,7,2024-2025,21,fr FRA,Villarreal,es La Liga,20,1348,15.0,15,5,0,7,3,10,6,1,1,0,FW,52c3244b,Rotational Player
787,Seko Fofana,7,2022-2023,27,ci CIV,Lens,fr Ligue 1,35,3073,34.1,34,1,1,7,5,12,6,1,2,1,MF,5313ed43,Full Starter
788,Hamed Junior Traorè,7,2021-2022,21,ci CIV,Sassuolo,it Serie A,31,1775,19.7,21,10,1,7,2,9,7,0,0,0,FWMF,570bb4b9,Rotational Player
789,Jude Bellingham,7,2024-2025,21,eng ENG,Real Madrid,es La Liga,17,1410,15.7,17,0,0,7,6,13,6,1,2,1,MF,57d88cf9,Full Starter
790,Dimitri Payet,7,2020-2021,33,fr FRA,Marseille,fr Ligue 1,33,2417,26.9,28,5,0,7,10,17,7,0,1,1,FWMF,58ae47b2,Rotational Player
791,Mason Greenwood,7,2020-2021,18,eng ENG,Manchester Utd,eng Premier League,31,1822,20.2,21,10,4,7,2,9,7,0,0,0,FW,58eee997,Rotational Player
792,Dominic Calvert-Lewin,7,2023-2024,26,eng ENG,Everton,eng Premier League,32,2171,24.1,26,6,0,7,2,9,5,2,2,0,FW,59e6e5bf,Rotational Player
793,Juraj Kucka,7,2020-2021,33,sk SVK,Parma,it Serie A,28,2334,25.9,28,0,0,7,2,9,3,4,4,0,MFFW,5aaef9ef,Full Starter
794,Karl Toko Ekambi,7,2022-2023,29,cm CMR,2 Teams,fr Ligue 1,36,2325,25.8,26,10,0,7,4,11,7,0,0,0,FWMF,5ceba7fc,Full Starter
795,Patrik Schick,7,2023-2024,27,cz CZE,Leverkusen,de Bundesliga,20,1063,11.8,12,8,4,7,0,7,6,1,1,0,FW,5d4f7d61,Rotational Player
796,Andrej Kramarić,7,2024-2025,33,hr CRO,Hoffenheim,de Bundesliga,18,1532,17.0,18,0,0,7,2,9,5,2,2,0,MFFW,603cb947,Rotational Player
797,Ludovic Blas,7,2022-2023,24,fr FRA,Nantes,fr Ligue 1,37,2813,31.3,30,7,1,7,5,12,5,2,4,2,MFFW,6191093d,Full Starter
798,Álvaro Negredo,7,2021-2022,35,es ESP,Cádiz,es La Liga,34,2157,24.0,24,10,4,7,2,9,5,2,3,1,FW,63b0ca6b,Full Starter
799,Rodri,7,2021-2022,25,es ESP,Manchester City,eng Premier League,33,2884,32.0,33,0,2,7,2,9,7,0,0,0,MF,6434f10d,Full Starter
800,Tomáš Souček,7,2023-2024,28,cz CZE,West Ham,eng Premier League,37,2870,31.9,34,3,0,7,2,9,7,0,0,0,MF,6613c819,Full Starter
801,Alex Iwobi,7,2024-2025,28,ng NGA,Fulham,eng Premier League,23,1938,21.5,23,0,0,7,3,10,7,0,0,0,FWMF,6ca5ec4b,Rotational Player
802,Youssoufa Moukoko,7,2022-2023,17,de GER,Dortmund,de Bundesliga,26,1141,12.7,11,15,3,7,3,10,7,0,0,0,FW,6ce43701,Bench Player
803,Papu Gómez,7,2020-2021,32,ar ARG,2 Teams,2 Comps,28,1580,17.6,20,8,2,7,3,10,7,0,0,0,MFFW,6e4df551,Rotational Player
804,Hernani,7,2020-2021,26,br BRA,Parma,it Serie A,33,2189,24.3,27,6,0,7,3,10,6,1,1,0,MF,6f5ead86,Rotational Player
805,Tetê,7,2022-2023,22,br BRA,2 Teams,2 Comps,30,1841,20.5,23,7,7,7,2,9,7,0,0,0,FWMF,7120a04d,Rotational Player
806,Kaoru Mitoma,7,2022-2023,25,jp JPN,Brighton,eng Premier League,33,2318,25.8,24,9,2,7,5,12,7,0,0,0,FWMF,74618572,Rotational Player
807,Martin Ødegaard,7,2021-2022,22,no NOR,Arsenal,eng Premier League,36,2785,30.9,32,4,0,7,4,11,7,0,0,0,MFFW,79300479,Full Starter
808,Dušan Vlahović,7,2024-2025,24,rs SRB,Juventus,it Serie A,18,1337,14.9,16,2,0,7,1,8,3,4,4,0,FW,79443529,Full Starter
809,Saîf-Eddine Khaoui,7,2022-2023,27,tn TUN,Clermont Foot,fr Ligue 1,34,2027,22.5,23,11,1,7,3,10,7,0,0,0,MF,796b1c41,Rotational Player
810,Ondrej Duda,7,2020-2021,25,sk SVK,Köln,de Bundesliga,32,2537,28.2,32,0,0,7,5,12,4,3,4,1,FWMF,79ca3e23,Full Starter
811,Florian Sotoca,7,2022-2023,31,fr FRA,Lens,fr Ligue 1,38,3054,33.9,34,4,0,7,9,16,6,1,3,2,MFFW,7a42d0df,Full Starter
812,Florian Sotoca,7,2023-2024,32,fr FRA,Lens,fr Ligue 1,32,2598,28.9,29,3,0,7,6,13,3,4,4,0,MFFW,7a42d0df,Full Starter
813,Alejandro Garnacho,7,2023-2024,19,ar ARG,Manchester Utd,eng Premier League,36,2565,28.5,30,6,2,7,4,11,7,0,0,0,FW,7aa8adfe,Rotational Player
814,Rony Lopes,7,2022-2023,26,pt POR,Troyes,fr Ligue 1,32,2346,26.1,29,3,1,7,5,12,7,0,0,0,MFFW,7c2965bb,Full Starter
815,Gio Reyna,7,2022-2023,19,us USA,Dortmund,de Bundesliga,22,625,6.9,4,18,6,7,2,9,6,1,1,0,FWMF,7fa4e703,Rotational Player
816,Gerard Moreno,7,2022-2023,30,es ESP,Villarreal,es La Liga,21,1230,13.7,14,7,1,7,3,10,6,1,2,1,FW,81f0781e,Rotational Player
817,Bruno Guimarães,7,2023-2024,25,br BRA,Newcastle Utd,eng Premier League,37,3263,36.3,37,0,0,7,8,15,7,0,0,0,MF,82518f62,Full Starter
818,Mathys Tel,7,2023-2024,18,fr FRA,Bayern Munich,de Bundesliga,30,1050,11.7,6,24,4,7,5,12,7,0,0,0,FWMF,829aa60c,Bench Player
819,Sandro Ramírez,7,2024-2025,29,es ESP,Las Palmas,es La Liga,18,1227,13.6,15,3,0,7,3,10,7,0,0,0,FWMF,833fb62e,Rotational Player
820,Anastasios Douvikas,7,2023-2024,23,gr GRE,Celta Vigo,es La Liga,32,905,10.1,7,25,3,7,1,8,7,0,0,0,FW,853ca71c,Bench Player
821,Arkadiusz Milik,7,2022-2023,28,pl POL,2 Teams,2 Comps,29,1715,19.1,19,10,2,7,1,8,7,0,1,1,FW,85613cf0,Rotational Player
822,Arkadiusz Milik,7,2021-2022,27,pl POL,Marseille,fr Ligue 1,23,1416,15.7,15,8,3,7,2,9,6,1,1,0,FW,85613cf0,Rotational Player
823,Mahdi Camara,7,2023-2024,25,fr FRA,Brest,fr Ligue 1,32,2020,22.4,26,6,0,7,3,10,6,1,1,0,MF,8577e60a,Full Starter
824,João Félix,7,2023-2024,23,pt POR,2 Teams,es La Liga,30,1540,17.1,18,12,3,7,3,10,7,0,0,0,FW,8aafd64f,Rotational Player
825,João Félix,7,2020-2021,20,pt POR,Atlético Madrid,es La Liga,31,1572,17.5,14,17,0,7,5,12,6,1,2,1,FWMF,8aafd64f,Rotational Player
826,Michael Gregoritsch,7,2023-2024,29,at AUT,Freiburg,de Bundesliga,32,1682,18.7,19,13,0,7,4,11,7,0,0,0,FW,8e235926,Rotational Player
827,Manolo Gabbiadini,7,2022-2023,30,it ITA,Sampdoria,it Serie A,35,2354,26.2,27,8,2,7,2,9,7,0,0,0,FWMF,8f866fe8,Rotational Player
828,Álvaro García,7,2021-2022,28,es ESP,Rayo Vallecano,es La Liga,36,2998,33.3,34,2,0,7,4,11,7,0,0,0,FWMF,90bbd822,Full Starter
829,Wesley Saïd,7,2023-2024,28,fr FRA,Lens,fr Ligue 1,27,1020,11.3,11,16,1,7,1,8,7,0,0,0,FWMF,90fcf472,Bench Player
830,Shuto Machino,7,2024-2025,24,jp JPN,Holstein Kiel,de Bundesliga,18,982,10.9,12,6,1,7,1,8,6,1,1,0,FWMF,964dde35,Rotational Player
831,Emil Forsberg,7,2020-2021,28,se SWE,RB Leipzig,de Bundesliga,29,1539,17.1,20,9,1,7,4,11,5,2,3,1,FWMF,9a2e0ccc,Rotational Player
832,Ferrán Torres,7,2023-2024,23,es ESP,Barcelona,es La Liga,29,1211,13.5,12,17,2,7,2,9,7,0,0,0,FW,9e1035f8,Rotational Player
833,Ferrán Torres,7,2020-2021,20,es ESP,Manchester City,eng Premier League,24,1306,14.5,15,9,13,7,2,9,7,0,0,0,FWMF,9e1035f8,Rotational Player
834,Jhon Córdoba,7,2020-2021,27,co COL,Hertha BSC,de Bundesliga,21,1537,17.1,17,4,0,7,1,8,7,0,0,0,FW,9f381d8b,Rotational Player
835,Julian Brandt,7,2023-2024,27,de GER,Dortmund,de Bundesliga,32,2223,24.7,26,6,0,7,11,18,7,0,0,0,MFFW,a167537f,Rotational Player
836,Marcus Rashford,7,2023-2024,25,eng ENG,Manchester Utd,eng Premier League,33,2271,25.2,26,7,0,7,2,9,5,2,2,0,FW,a1d5bd30,Rotational Player
837,Ihlas Bebou,7,2023-2024,29,tg TOG,Hoffenheim,de Bundesliga,32,1636,18.2,16,16,2,7,5,12,7,0,0,0,FWDF,a53b661f,Rotational Player
838,Ihlas Bebou,7,2022-2023,28,tg TOG,Hoffenheim,de Bundesliga,19,1416,15.7,17,2,0,7,0,7,6,1,1,0,FWDF,a53b661f,Rotational Player
839,Ihlas Bebou,7,2021-2022,27,tg TOG,Hoffenheim,de Bundesliga,28,2091,23.2,25,3,0,7,2,9,7,0,0,0,FWDF,a53b661f,Rotational Player
840,Houssem Aouar,7,2020-2021,22,dz ALG,Lyon,fr Ligue 1,30,1781,19.8,23,7,1,7,3,10,5,2,2,0,MFFW,a5db0bec,Rotational Player
841,Amine Gouiri,7,2023-2024,23,dz ALG,Rennes,fr Ligue 1,31,2067,23.0,24,7,2,7,3,10,7,0,0,0,FWMF,aad56ca3,Full Starter
842,Wilfried Zaha,7,2022-2023,29,ci CIV,Crystal Palace,eng Premier League,27,2288,25.4,27,0,0,7,2,9,7,0,2,2,FWMF,b2bc3b1f,Full Starter
843,Nolito,7,2020-2021,33,es ESP,Celta Vigo,es La Liga,36,2597,28.9,35,1,1,7,5,12,7,0,0,0,MFFW,b2d0ec1b,Full Starter
844,Raúl Jiménez,7,2023-2024,32,mx MEX,Fulham,eng Premier League,24,1395,15.5,18,6,5,7,0,7,7,0,0,0,FW,b561db50,Rotational Player
845,Maghnes Akliouche,7,2023-2024,21,fr FRA,Monaco,fr Ligue 1,28,1613,17.9,18,10,3,7,4,11,7,0,0,0,MFFW,b625b241,Rotational Player
846,Solly March,7,2022-2023,28,eng ENG,Brighton,eng Premier League,33,2715,30.2,31,2,0,7,7,14,7,0,0,0,FWDF,bb5fbd2b,Rotational Player
847,Alassane Pléa,7,2023-2024,30,fr FRA,Gladbach,de Bundesliga,27,1913,21.3,24,3,0,7,4,11,6,1,1,0,FWMF,bc6bd723,Rotational Player
848,Oihan Sancet,7,2024-2025,24,es ESP,Athletic Club,es La Liga,17,1029,11.4,13,4,0,7,1,8,6,1,1,0,MF,bdb624a3,Rotational Player
849,Noni Madueke,7,2024-2025,22,eng ENG,Chelsea,eng Premier League,21,1373,15.3,17,4,1,7,3,10,7,0,0,0,FW,bf34eebd,Rotational Player
850,Arnaud Kalimuendo,7,2022-2023,20,fr FRA,2 Teams,fr Ligue 1,30,1849,20.5,24,6,1,7,3,10,7,0,0,0,FW,bf4c41f9,Rotational Player
851,Arnaud Kalimuendo,7,2020-2021,18,fr FRA,2 Teams,fr Ligue 1,29,1291,14.3,14,15,6,7,3,10,7,0,0,0,FW,bf4c41f9,Rotational Player
852,Randal Kolo Muani,7,2023-2024,24,fr FRA,2 Teams,2 Comps,28,1421,15.8,15,13,2,7,5,12,7,0,0,0,FWMF,c0b3669f,Rotational Player
853,Fabián Ruiz Peña,7,2021-2022,25,es ESP,Napoli,it Serie A,32,2384,26.5,29,3,1,7,4,11,7,0,0,0,MF,c0c7ff58,Full Starter
854,Ellyes Skhiri,7,2022-2023,27,tn TUN,Köln,de Bundesliga,32,2856,31.7,32,0,0,7,1,8,7,0,0,0,MF,c2211709,Full Starter
855,Bertrand Traoré,7,2020-2021,24,bf BFA,2 Teams,2 Comps,36,2317,25.7,29,7,2,7,6,13,7,0,0,0,FW,c47541e0,Full Starter
856,Wout Weghorst,7,2023-2024,30,nl NED,Hoffenheim,de Bundesliga,28,1977,22.0,24,4,1,7,3,10,6,1,1,0,FW,c4e87b8b,Full Starter
857,Sadio Mané,7,2022-2023,30,sn SEN,Bayern Munich,de Bundesliga,25,1425,15.8,18,7,1,7,5,12,6,1,2,1,FWMF,c691bfe2,Full Starter
858,Thomas Mangani,7,2021-2022,34,fr FRA,Angers,fr Ligue 1,33,2193,24.4,25,8,4,7,2,9,1,6,6,0,MF,c801616a,Full Starter
859,Lucas Höler,7,2021-2022,27,de GER,Freiburg,de Bundesliga,34,2583,28.7,30,4,0,7,2,9,7,0,0,0,FW,ca618d23,Rotational Player
860,Lucas Höler,7,2023-2024,29,de GER,Freiburg,de Bundesliga,33,2305,25.6,26,7,0,7,2,9,6,1,2,1,FWMF,ca618d23,Rotational Player
861,Hakan Çalhanoğlu,7,2021-2022,27,tr TUR,Inter,it Serie A,34,2480,27.6,33,1,2,7,12,19,4,3,3,0,MF,cd0fa27b,Full Starter
862,Ritsu Doan,7,2023-2024,25,jp JPN,Freiburg,de Bundesliga,30,2246,25.0,26,4,0,7,2,9,7,0,0,0,DFMF,d01bbb6f,Full Starter
863,David Okereke,7,2021-2022,23,ng NGA,Venezia,it Serie A,32,2053,22.8,24,8,0,7,0,7,7,0,0,0,FWMF,d125f22f,Rotational Player
864,David Okereke,7,2022-2023,24,ng NGA,Cremonese,it Serie A,33,2266,25.2,25,8,2,7,0,7,6,1,1,0,FWMF,d125f22f,Rotational Player
865,Philip Billing,7,2022-2023,26,dk DEN,Bournemouth,eng Premier League,36,2764,30.7,34,2,0,7,1,8,7,0,0,0,MFFW,d328a254,Full Starter
866,Stephan El Shaarawy,7,2022-2023,29,it ITA,Roma,it Serie A,29,1523,16.9,14,15,5,7,2,9,7,0,0,0,DFMF,d3aaad90,Rotational Player
867,Lucas Boyé,7,2020-2021,24,ar ARG,Elche,es La Liga,34,2694,29.9,32,2,0,7,2,9,7,0,0,0,FW,d49f3e6b,Full Starter
868,Lucas Boyé,7,2021-2022,25,ar ARG,Elche,es La Liga,24,1713,19.0,22,2,0,7,3,10,7,0,0,0,FW,d49f3e6b,Full Starter
869,Lucas Boyé,7,2022-2023,26,ar ARG,Elche,es La Liga,35,2462,27.4,29,6,0,7,2,9,7,0,1,1,FW,d49f3e6b,Full Starter
870,Josip Brekalo,7,2020-2021,22,hr CRO,Wolfsburg,de Bundesliga,29,1814,20.2,22,7,2,7,3,10,7,0,0,0,FW,d4a2533d,Rotational Player
871,Josip Brekalo,7,2021-2022,23,hr CRO,2 Teams,2 Comps,33,2307,25.6,26,7,3,7,3,10,7,0,0,0,FW,d4a2533d,Rotational Player
872,Theo Hernández,7,2020-2021,22,fr FRA,Milan,it Serie A,33,2933,32.6,33,0,1,7,5,12,7,0,0,0,DF,d4c9725f,Full Starter
873,Goran Pandev,7,2020-2021,37,mk MKD,Genoa,it Serie A,29,1404,15.6,15,14,2,7,3,10,6,1,1,0,FWMF,d711d04f,Rotational Player
874,Roberto Torres,7,2020-2021,31,es ESP,Osasuna,es La Liga,35,1894,21.0,19,16,0,7,1,8,3,4,5,1,MFFW,d733aa38,Rotational Player
875,Giovani Lo Celso,7,2024-2025,28,ar ARG,Betis,es La Liga,13,944,10.5,10,3,0,7,1,8,5,2,2,0,MFFW,d7553721,Rotational Player
876,Scott McTominay,7,2023-2024,26,sct SCO,Manchester Utd,eng Premier League,32,1901,21.1,18,14,2,7,1,8,7,0,0,0,MFFW,d93c2511,Rotational Player
877,Valentín Castellanos,7,2024-2025,25,ar ARG,Lazio,it Serie A,19,1583,17.6,18,1,0,7,1,8,5,2,3,1,FW,da76bab4,Rotational Player
878,Álex Berenguer,7,2023-2024,28,es ESP,Athletic Club,es La Liga,35,1592,17.7,15,20,1,7,3,10,6,1,1,0,FW,dc1c2fce,Rotational Player
879,Matheus Cunha,7,2020-2021,21,br BRA,Hertha BSC,de Bundesliga,27,2149,23.9,25,2,0,7,4,11,5,2,3,1,FWMF,dc62b55d,Rotational Player
880,Deniz Undav,7,2024-2025,28,de GER,Stuttgart,de Bundesliga,13,859,9.5,10,3,0,7,1,8,7,0,0,0,FWMF,dd549382,Rotational Player
881,Andrey Santos,7,2024-2025,20,br BRA,Strasbourg,fr Ligue 1,18,1595,17.7,18,0,0,7,1,8,7,0,0,0,MF,dd745366,Rotational Player
882,Yannick Carrasco,7,2022-2023,28,be BEL,Atlético Madrid,es La Liga,35,2317,25.7,26,9,1,7,3,10,6,1,1,0,DFMF,de39485a,Full Starter
883,Antoine Griezmann,7,2024-2025,33,fr FRA,Atlético Madrid,es La Liga,21,1540,17.1,18,3,0,7,4,11,6,1,2,1,FWMF,df69b544,Full Starter
884,Riccardo Orsolini,7,2020-2021,23,it ITA,Bologna,it Serie A,34,1755,19.5,21,13,0,7,3,10,4,3,3,0,FWMF,e14ec482,Rotational Player
885,Riccardo Orsolini,7,2024-2025,27,it ITA,Bologna,it Serie A,17,1052,11.7,13,4,1,7,3,10,5,2,2,0,FW,e14ec482,Rotational Player
886,Imran Louza,7,2020-2021,21,ma MAR,Nantes,fr Ligue 1,33,2379,26.4,28,5,1,7,2,9,2,5,5,0,MF,e1df6989,Full Starter
887,Achraf Hakimi,7,2020-2021,21,ma MAR,Inter,it Serie A,37,2665,29.6,29,8,0,7,8,15,7,0,0,0,DF,e42d61c7,Rotational Player
888,Kevin De Bruyne,7,2022-2023,31,be BEL,Manchester City,eng Premier League,32,2417,26.9,28,4,3,7,16,23,7,0,0,0,MF,e46012d4,Rotational Player
889,Kevin Stöger,7,2023-2024,29,at AUT,Bochum,de Bundesliga,32,2668,29.6,32,0,0,7,10,17,3,4,4,0,MF,e5649a78,Rotational Player
890,Granit Xhaka,7,2022-2023,29,ch SUI,Arsenal,eng Premier League,37,2993,33.3,36,1,0,7,7,14,7,0,0,0,MF,e61b8aee,Full Starter
891,Mateo Retegui,7,2023-2024,24,it ITA,Genoa,it Serie A,29,2216,24.6,26,3,1,7,2,9,6,1,1,0,FW,e7695e6c,Rotational Player
892,Dominic Solanke,7,2024-2025,26,eng ENG,Tottenham,eng Premier League,18,1598,17.8,18,0,0,7,3,10,7,0,0,0,FW,e77dc3b2,Full Starter
893,Florian Wirtz,7,2021-2022,18,de GER,Leverkusen,de Bundesliga,24,1851,20.6,22,2,0,7,10,17,7,0,0,0,MFFW,e7fcf289,Rotational Player
894,Phil Foden,7,2024-2025,24,eng ENG,Manchester City,eng Premier League,18,1293,14.4,14,4,1,7,2,9,7,0,0,0,MFFW,ed1e53f3,Rotational Player
895,Lewis Ferguson,7,2022-2023,22,sct SCO,Bologna,it Serie A,32,2314,25.7,27,5,4,7,0,7,7,0,0,0,MFFW,ee64a822,Full Starter
896,Luis Javier Suárez,7,2022-2023,24,co COL,2 Teams,2 Comps,28,1783,19.8,20,8,8,7,5,12,7,0,0,0,FW,eeba07f8,Rotational Player
897,Antoine Semenyo,7,2024-2025,24,gh GHA,Bournemouth,eng Premier League,22,1926,21.4,22,0,0,7,3,10,7,0,0,0,FW,efd2ec23,Rotational Player
898,Che Adams,7,2024-2025,28,sct SCO,Torino,it Serie A,21,1424,15.8,16,5,0,7,2,9,7,0,0,0,FW,f2bf1b0f,Rotational Player
899,Che Adams,7,2021-2022,25,sct SCO,Southampton,eng Premier League,30,2039,22.7,23,7,4,7,3,10,7,0,0,0,FW,f2bf1b0f,Rotational Player
900,Muhammed Cham,7,2022-2023,21,at AUT,Clermont Foot,fr Ligue 1,38,1968,21.9,23,15,0,7,4,11,5,2,2,0,MF,f527a32c,Full Starter
901,Jørgen Strand Larsen,7,2024-2025,24,no NOR,Wolves,eng Premier League,23,1833,20.4,22,1,0,7,2,9,7,0,0,0,FW,f553b2b3,Full Starter
902,Yusuf Yazıcı,7,2020-2021,23,tr TUR,Lille,fr Ligue 1,32,1086,12.1,10,22,1,7,4,11,7,0,0,0,FWMF,f5c8b425,Rotational Player
903,Richarlison,7,2020-2021,23,br BRA,Everton,eng Premier League,34,2861,31.8,33,1,0,7,3,10,6,1,1,0,FW,fa031b34,Full Starter
904,Mama Samba Baldé,7,2020-2021,24,gw GNB,Dijon,fr Ligue 1,29,2161,24.0,24,5,0,7,0,7,7,0,0,0,FW,fb14aa28,Rotational Player
905,Dwight McNeil,7,2022-2023,22,eng ENG,Everton,eng Premier League,36,2498,27.8,28,8,2,7,3,10,7,0,0,0,FWMF,fc15fb84,Rotational Player
906,Kai Havertz,7,2022-2023,23,de GER,Chelsea,eng Premier League,35,2569,28.5,30,5,1,7,1,8,6,1,1,0,FWMF,fed7cb61,Rotational Player
907,Zinedine Ferhat,6,2020-2021,27,dz ALG,Nîmes,fr Ligue 1,33,2957,32.9,33,0,0,6,10,16,5,1,1,0,FWMF,005c0807,Rotational Player
908,Przemysław Frankowski,6,2021-2022,26,pl POL,Lens,fr Ligue 1,37,2448,27.2,28,9,0,6,5,11,6,0,0,0,DF,00a8d210,Rotational Player
909,Marcos Llorente,6,2023-2024,28,es ESP,Atlético Madrid,es La Liga,37,2565,28.5,29,8,0,6,4,10,6,0,0,0,MFDF,02c15616,Rotational Player
910,Simone Verdi,6,2021-2022,29,it ITA,2 Teams,it Serie A,18,875,9.7,11,7,7,6,0,6,5,1,1,0,MFFW,0375723e,Rotational Player
911,Kingsley Coman,6,2021-2022,25,fr FRA,Bayern Munich,de Bundesliga,21,1359,15.1,16,5,0,6,2,8,6,0,0,0,FWDF,042e8a49,Rotational Player
912,Odsonne Édouard,6,2021-2022,23,fr FRA,Crystal Palace,eng Premier League,28,1564,17.4,18,10,7,6,3,9,5,1,1,0,FW,0562b7f1,Rotational Player
913,Franck Kessié,6,2021-2022,24,ci CIV,Milan,it Serie A,31,2308,25.6,25,6,0,6,0,6,4,2,3,1,MF,05e19d6a,Full Starter
914,Maximilian Philipp,6,2020-2021,26,de GER,Wolfsburg,de Bundesliga,24,1111,12.3,13,11,4,6,2,8,6,0,0,0,MF,061e8e23,Rotational Player
915,Sergi Darder,6,2022-2023,28,es ESP,Espanyol,es La Liga,38,3320,36.9,38,0,0,6,3,9,6,0,0,0,MF,070a3904,Full Starter
916,Assan Ceesay,6,2022-2023,28,gm GAM,Lecce,it Serie A,34,1812,20.1,20,14,3,6,0,6,5,1,1,0,FW,07f8bcc8,Rotational Player
917,Andrea Pinamonti,6,2024-2025,25,it ITA,Genoa,it Serie A,20,1639,18.2,19,1,0,6,1,7,6,0,0,0,FW,08aa9cd1,Full Starter
918,Sergio León,6,2022-2023,33,es ESP,Valladolid,es La Liga,29,1334,14.8,14,15,7,6,1,7,5,1,2,1,FW,0a0cc13c,Rotational Player
919,Antonio Sanabria,6,2021-2022,25,py PAR,Torino,it Serie A,29,1803,20.0,22,7,3,6,1,7,6,0,0,0,FW,0a447501,Rotational Player
920,Romain Hamouma,6,2020-2021,33,fr FRA,Saint-Étienne,fr Ligue 1,29,1769,19.7,19,10,0,6,1,7,6,0,0,0,FWMF,0b4d8274,Rotational Player
921,Romain Del Castillo,6,2022-2023,26,fr FRA,Brest,fr Ligue 1,27,1422,15.8,16,11,0,6,6,12,1,5,5,0,MFFW,0be95d34,Rotational Player
922,Pedri,6,2022-2023,19,es ESP,Barcelona,es La Liga,26,1976,22.0,22,4,0,6,1,7,6,0,0,0,MF,0d9b2d31,Rotational Player
923,Bobby Reid,6,2023-2024,30,jm JAM,Fulham,eng Premier League,33,1423,15.8,17,16,5,6,2,8,6,0,0,0,FW,0f7533cd,Rotational Player
924,Davie Selke,6,2023-2024,28,de GER,Köln,de Bundesliga,19,1265,14.1,16,3,1,6,0,6,6,0,0,0,FW,1238a3f9,Rotational Player
925,Davie Selke,6,2022-2023,27,de GER,2 Teams,de Bundesliga,30,1151,12.8,15,15,2,6,1,7,5,1,1,0,FW,1238a3f9,Rotational Player
926,Takuma Asano,6,2023-2024,28,jp JPN,Bochum,de Bundesliga,29,1986,22.1,26,3,0,6,1,7,6,0,0,0,FWMF,13ddc856,Rotational Player
927,Jacob Ramsey,6,2021-2022,20,eng ENG,Aston Villa,eng Premier League,34,2467,27.4,29,5,1,6,1,7,6,0,0,0,MF,1544f145,Full Starter
928,Jacob Ramsey,6,2022-2023,21,eng ENG,Aston Villa,eng Premier League,35,2636,29.3,31,4,0,6,7,13,6,0,0,0,MFFW,1544f145,Full Starter
929,Julián Álvarez,6,2024-2025,24,ar ARG,Atlético Madrid,es La Liga,21,1366,15.2,16,5,0,6,2,8,6,0,0,0,FWMF,15ab5a2b,Rotational Player
930,Sasa Kalajdzic,6,2021-2022,24,at AUT,Stuttgart,de Bundesliga,15,1221,13.6,13,2,1,6,1,7,5,1,2,1,FW,15f24fe7,Rotational Player
931,Gaëtan Charbonnier,6,2020-2021,31,fr FRA,Brest,fr Ligue 1,36,1570,17.4,17,19,1,6,1,7,5,1,1,0,MFFW,18ebca4b,Rotational Player
932,Raúl,6,2023-2024,22,es ESP,Osasuna,es La Liga,35,1355,15.1,13,22,2,6,1,7,6,0,0,0,FW,18f0a9f0,Bench Player
933,Sofiane Diop,6,2021-2022,21,fr FRA,Monaco,fr Ligue 1,30,1948,21.6,24,6,7,6,4,10,6,0,0,0,MFFW,19053e31,Rotational Player
934,Steve Mounié,6,2022-2023,27,bj BEN,Brest,fr Ligue 1,23,1655,18.4,20,3,1,6,0,6,5,1,1,0,FW,19ba6c6d,Rotational Player
935,Steve Mounié,6,2023-2024,28,bj BEN,Brest,fr Ligue 1,32,1769,19.7,20,12,0,6,2,8,6,0,0,0,FW,19ba6c6d,Rotational Player
936,Youcef Belaïli,6,2022-2023,30,dz ALG,2 Teams,fr Ligue 1,23,1506,16.7,19,4,1,6,5,11,1,5,6,1,MFFW,1a248246,Rotational Player
937,Matthew Hoppe,6,2020-2021,19,us USA,Schalke 04,de Bundesliga,22,1305,14.5,15,7,3,6,1,7,6,0,0,0,FW,1bc432b7,Rotational Player
938,Christian Pulisic,6,2024-2025,25,us USA,Milan,it Serie A,17,1206,13.4,15,2,0,6,4,10,4,2,2,0,FWMF,1bf33a9a,Rotational Player
939,Christian Pulisic,6,2021-2022,22,us USA,Chelsea,eng Premier League,22,1290,14.3,13,9,5,6,2,8,6,0,0,0,MFFW,1bf33a9a,Rotational Player
940,Jakub Jankto,6,2020-2021,24,cz CZE,Sampdoria,it Serie A,35,2409,26.8,29,6,1,6,3,9,6,0,0,0,MF,1ea5f91c,Full Starter
941,Rodrigo,6,2021-2022,30,es ESP,Leeds United,eng Premier League,31,2265,25.2,27,4,2,6,1,7,5,1,1,0,MFFW,1fb1c435,Rotational Player
942,M'Baye Niang,6,2023-2024,28,sn SEN,Empoli,it Serie A,14,708,7.9,5,9,2,6,1,7,2,4,4,0,FW,2054d037,Bench Player
943,M'Baye Niang,6,2022-2023,27,sn SEN,Auxerre,fr Ligue 1,30,1482,16.5,17,13,0,6,0,6,3,3,3,0,FW,2054d037,Bench Player
944,Rafael Leão,6,2020-2021,21,pt POR,Milan,it Serie A,30,1924,21.4,22,8,1,6,6,12,6,0,0,0,FW,20730eae,Full Starter
945,Jonas Wind,6,2022-2023,23,dk DEN,Wolfsburg,de Bundesliga,24,1291,14.3,15,9,1,6,0,6,6,0,1,1,FW,2077ae86,Rotational Player
946,Benjamin Bourigeaud,6,2020-2021,26,fr FRA,Rennes,fr Ligue 1,37,2552,28.4,29,8,0,6,5,11,6,0,0,0,MFFW,20e73fac,Full Starter
947,Lazar Samardzic,6,2023-2024,21,rs SRB,Udinese,it Serie A,34,2372,26.4,28,6,4,6,2,8,5,1,1,0,MF,217c93a1,Rotational Player
948,Nicolás González,6,2022-2023,24,ar ARG,Fiorentina,it Serie A,24,1354,15.0,13,11,5,6,1,7,4,2,2,0,FWMF,2374aaca,Rotational Player
949,Nicolás González,6,2020-2021,22,ar ARG,Stuttgart,de Bundesliga,15,934,10.4,10,5,0,6,2,8,3,3,4,1,FWMF,2374aaca,Rotational Player
950,Boulaye Dia,6,2024-2025,27,sn SEN,Lazio,it Serie A,19,1180,13.1,14,5,2,6,3,9,6,0,0,0,MFFW,244bc2c8,Rotational Player
951,Ezequiel Ávila,6,2021-2022,27,ar ARG,Osasuna,es La Liga,36,1870,20.8,22,14,0,6,1,7,5,1,1,0,FWMF,253a06b9,Rotational Player
952,Marcus Ingvartsen,6,2021-2022,25,dk DEN,2 Teams,de Bundesliga,28,802,8.9,8,20,1,6,0,6,5,1,1,0,MF,271b8617,Rotational Player
953,Jonas Hofmann,6,2020-2021,28,de GER,Gladbach,de Bundesliga,24,1817,20.2,21,3,1,6,11,17,3,3,3,0,FWMF,2903a856,Full Starter
954,Samuel Lino,6,2022-2023,22,br BRA,Valencia,es La Liga,38,2887,32.1,33,5,0,6,1,7,6,0,0,0,FWMF,2a295d33,Rotational Player
955,Davide Frattesi,6,2023-2024,23,it ITA,Inter,it Serie A,32,955,10.6,6,26,4,6,3,9,6,0,0,0,MF,2a7d27c1,Rotational Player
956,Leroy Sané,6,2020-2021,24,de GER,Bayern Munich,de Bundesliga,32,1805,20.1,18,14,0,6,9,15,6,0,0,0,FWMF,2b114be3,Rotational Player
957,Anthony Gordon,6,2024-2025,23,eng ENG,Newcastle Utd,eng Premier League,22,1766,19.6,21,1,0,6,5,11,5,1,2,1,FW,2bd83368,Rotational Player
958,Jamal Musiala,6,2020-2021,17,de GER,Bayern Munich,de Bundesliga,26,881,9.8,7,19,8,6,1,7,6,0,0,0,FWMF,2c0558b8,Rotational Player
959,Armand Lauriente,6,2021-2022,22,fr FRA,Lorient,fr Ligue 1,35,2477,27.5,28,7,0,6,2,8,5,1,1,0,FWMF,2d22cea7,Full Starter
960,Robin Gosens,6,2023-2024,29,de GER,Union Berlin,de Bundesliga,30,2283,25.4,27,3,0,6,3,9,6,0,0,0,DFMF,2d970560,Rotational Player
961,Morgan Rogers,6,2024-2025,22,eng ENG,Aston Villa,eng Premier League,22,1809,20.1,22,0,0,6,4,10,6,0,0,0,MFFW,2e5915f1,Rotational Player
962,Dango Ouattara,6,2024-2025,22,bf BFA,Bournemouth,eng Premier League,20,1151,12.8,11,9,0,6,4,10,6,0,0,0,FW,2f9e4435,Rotational Player
963,Pere Milla,6,2022-2023,29,es ESP,Elche,es La Liga,31,1843,20.5,21,10,0,6,1,7,3,3,3,0,FWMF,335039a2,Rotational Player
964,Raphinha,6,2023-2024,26,br BRA,Barcelona,es La Liga,28,1368,15.2,17,11,2,6,9,15,5,1,1,0,FWMF,3423f250,Full Starter
965,Giovanni Simeone,6,2020-2021,25,ar ARG,Cagliari,it Serie A,33,1740,19.3,19,14,3,6,2,8,6,0,0,0,FW,343c0d52,Rotational Player
966,Edon Zhegrova,6,2023-2024,24,xk KVX,Lille,fr Ligue 1,33,2288,25.4,25,8,1,6,6,12,6,0,0,0,FW,34a88e3e,Rotational Player
967,Lee Jae-sung,6,2023-2024,30,kr KOR,Mainz 05,de Bundesliga,29,2113,23.5,24,5,0,6,3,9,6,0,0,0,MFFW,34b0387f,Rotational Player
968,Sekou Mara,6,2021-2022,19,fr FRA,Bordeaux,fr Ligue 1,26,905,10.1,8,18,7,6,0,6,5,1,1,0,FWMF,3544641e,Bench Player
969,Antonio Candreva,6,2023-2024,36,it ITA,Salernitana,it Serie A,34,2750,30.6,32,2,0,6,6,12,5,1,1,0,MFFW,356c9002,Full Starter
970,Domenico Criscito,6,2021-2022,34,it ITA,Genoa,it Serie A,20,1618,18.0,18,2,3,6,1,7,0,6,7,1,DF,35dd6d80,Rotational Player
971,Léo Baptistão,6,2023-2024,30,br BRA,Almería,es La Liga,32,1837,20.4,22,10,1,6,0,6,6,0,0,0,FW,35f6db55,Rotational Player
972,Marco Reus,6,2022-2023,33,de GER,Dortmund,de Bundesliga,25,1353,15.0,14,11,0,6,4,10,5,1,1,0,MFFW,36a3ff67,Rotational Player
973,Marco Reus,6,2023-2024,34,de GER,Dortmund,de Bundesliga,26,1601,17.8,18,8,6,6,8,14,6,0,0,0,MFFW,36a3ff67,Rotational Player
974,Florian Neuhaus,6,2020-2021,23,de GER,Gladbach,de Bundesliga,33,2622,29.1,30,3,0,6,5,11,6,0,0,0,MF,36a59ba4,Rotational Player
975,Aleksandr Golovin,6,2023-2024,27,ru RUS,Monaco,fr Ligue 1,25,2147,23.9,25,0,0,6,6,12,6,0,0,0,MFFW,3708e9fa,Rotational Player
976,Arda Güler,6,2023-2024,18,tr TUR,Real Madrid,es La Liga,10,377,4.2,4,6,11,6,0,6,6,0,0,0,FWMF,3741ca58,Bench Player
977,Ramy Bensebaini,6,2022-2023,27,dz ALG,Gladbach,de Bundesliga,28,2481,27.6,28,0,0,6,1,7,4,2,2,0,DF,378825c7,Rotational Player
978,Shon Weissman,6,2020-2021,24,il ISR,Valladolid,es La Liga,32,2133,23.7,24,8,3,6,1,7,6,0,0,0,FW,379dc075,Rotational Player
979,Andrei Girotto,6,2021-2022,29,br BRA,Nantes,fr Ligue 1,36,3146,35.0,36,0,0,6,1,7,6,0,0,0,DFMF,3befc2b6,Full Starter
980,Moise Kean,6,2022-2023,22,it ITA,Juventus,it Serie A,28,995,11.1,11,17,2,6,0,6,6,0,0,0,FW,3d50bcdb,Rotational Player
981,Harvey Barnes,6,2021-2022,23,eng ENG,Leicester City,eng Premier League,32,2101,23.3,24,8,3,6,10,16,6,0,0,0,FWMF,3ea50f67,Rotational Player
982,Bernardo Silva,6,2023-2024,28,pt POR,Manchester City,eng Premier League,33,2578,28.6,29,4,2,6,9,15,6,0,0,0,MFFW,3eb22ec9,Full Starter
983,Brahim Díaz,6,2022-2023,22,ma MAR,Milan,it Serie A,33,1925,21.4,27,6,4,6,7,13,6,0,0,0,MFFW,407feb71,Rotational Player
984,Christoph Baumgartner,6,2020-2021,20,at AUT,Hoffenheim,de Bundesliga,31,2369,26.3,28,3,0,6,3,9,6,0,0,0,MFFW,437f2b00,Rotational Player
985,Ridle Baku,6,2020-2021,22,de GER,2 Teams,de Bundesliga,34,2858,31.8,33,1,0,6,7,13,6,0,0,0,FWDF,442b56fa,Full Starter
986,Matías Vecino,6,2023-2024,31,uy URU,Lazio,it Serie A,31,1153,12.8,8,23,5,6,1,7,6,0,0,0,MF,44ac04e9,Bench Player
987,Rúben Neves,6,2022-2023,25,pt POR,Wolves,eng Premier League,35,3019,33.5,33,2,0,6,1,7,3,3,3,0,MF,44bfb6c5,Full Starter
988,Evan Ferguson,6,2022-2023,17,ie IRL,Brighton,eng Premier League,19,950,10.6,10,9,2,6,2,8,6,0,0,0,FW,4596da74,Rotational Player
989,Evan Ferguson,6,2023-2024,18,ie IRL,Brighton,eng Premier League,27,1367,15.2,15,12,1,6,0,6,6,0,0,0,FW,4596da74,Rotational Player
990,Joaquín Correa,6,2021-2022,26,ar ARG,Inter,it Serie A,26,1025,11.4,12,14,0,6,1,7,6,0,0,0,FW,45b9b619,Rotational Player
991,Jorginho,6,2021-2022,29,it ITA,Chelsea,eng Premier League,29,2273,25.3,26,3,7,6,2,8,0,6,7,1,MF,45db685d,Rotational Player
992,Ibrahima Niane,6,2020-2021,21,sn SEN,Metz,fr Ligue 1,10,663,7.4,9,1,0,6,0,6,5,1,1,0,FW,46faabfa,Rotational Player
993,Nikola Krstović,6,2024-2025,24,me MNE,Lecce,it Serie A,22,1787,19.9,22,0,0,6,1,7,5,1,2,1,FW,473803c9,Full Starter
994,Denzel Dumfries,6,2024-2025,28,nl NED,Inter,it Serie A,18,1156,12.8,12,6,3,6,1,7,6,0,0,0,DFFW,481c9ece,Rotational Player
995,Lucas Beltrán,6,2023-2024,22,ar ARG,Fiorentina,it Serie A,32,1692,18.8,21,11,3,6,2,8,5,1,1,0,FWMF,482d2bc3,Rotational Player
996,Gabriel Martinelli,6,2021-2022,20,br BRA,Arsenal,eng Premier League,29,1860,20.7,21,8,7,6,6,12,5,1,1,0,FWMF,48a5a5d6,Rotational Player
997,Gabriel Martinelli,6,2024-2025,23,br BRA,Arsenal,eng Premier League,21,1368,15.2,15,6,2,6,2,8,6,0,0,0,FWMF,48a5a5d6,Rotational Player
998,Gabriel Martinelli,6,2023-2024,22,br BRA,Arsenal,eng Premier League,35,2019,22.4,24,11,0,6,4,10,6,0,0,0,FW,48a5a5d6,Rotational Player
999,Ruslan Malinovskyi,6,2021-2022,28,ua UKR,Atalanta,it Serie A,30,1592,17.7,19,11,1,6,5,11,6,0,0,0,MFFW,48d5bd33,Rotational Player
1000,Timo Werner,6,2020-2021,24,de GER,Chelsea,eng Premier League,35,2602,28.9,29,6,3,6,8,14,6,0,0,0,FWMF,49fe9070,Rotational Player
1001,Neal Maupay,6,2023-2024,26,fr FRA,2 Teams,eng Premier League,31,1432,15.9,14,17,3,6,3,9,6,0,0,0,FW,4bcf39f6,Rotational Player
1002,Justin Kluivert,6,2022-2023,23,nl NED,Valencia,es La Liga,26,1447,16.1,15,11,1,6,0,6,5,1,1,0,FWMF,4c3a6744,Rotational Player
1003,Casemiro,6,2020-2021,28,br BRA,Real Madrid,es La Liga,34,2901,32.2,32,2,0,6,4,10,6,0,0,0,MF,4d224fe8,Full Starter
1004,Luka Jović,6,2023-2024,25,rs SRB,2 Teams,it Serie A,23,877,9.7,8,15,8,6,1,7,6,0,0,0,FW,4d8cd038,Rotational Player
1005,Luka Jović,6,2022-2023,24,rs SRB,Fiorentina,it Serie A,31,1534,17.0,16,15,4,6,3,9,6,0,1,1,FWMF,4d8cd038,Rotational Player
1006,Simon Adingra,6,2023-2024,21,ci CIV,Brighton,eng Premier League,31,2222,24.7,25,6,1,6,1,7,6,0,0,0,FW,4dcec659,Rotational Player
1007,Szymon Żurkowski,6,2021-2022,23,pl POL,Empoli,it Serie A,35,2307,25.6,29,6,2,6,2,8,6,0,0,0,MF,4e1d5e59,Rotational Player
1008,Jacob Bruun Larsen,6,2023-2024,24,dk DEN,Burnley,eng Premier League,32,1249,13.9,16,16,5,6,0,6,5,1,1,0,MFFW,4e204552,Rotational Player
1009,Niclas Füllkrug,6,2020-2021,27,de GER,Werder Bremen,de Bundesliga,19,877,9.7,10,9,1,6,0,6,4,2,2,0,FW,4f16405e,Rotational Player
1010,Karim Adeyemi,6,2022-2023,20,de GER,Dortmund,de Bundesliga,24,1386,15.4,20,4,1,6,5,11,6,0,1,1,FWMF,501055d8,Rotational Player
1011,Stéphane Bahoken,6,2020-2021,28,cm CMR,Angers,fr Ligue 1,30,1616,18.0,18,12,0,6,2,8,6,0,1,1,FW,5046b7d4,Rotational Player
1012,Alex Baena,6,2022-2023,21,es ESP,Villarreal,es La Liga,35,1947,21.6,19,16,0,6,2,8,6,0,0,0,MFFW,518f2234,Rotational Player
1013,Luis Alberto,6,2022-2023,29,es ESP,Lazio,it Serie A,35,2442,27.1,27,8,2,6,7,13,5,1,2,1,MF,5294a83f,Full Starter
1014,Kevin Schade,6,2024-2025,22,de GER,Brentford,eng Premier League,23,1075,11.9,11,12,0,6,2,8,6,0,0,0,FW,52afb588,Bench Player
1015,Yeremi Pino,6,2021-2022,18,es ESP,Villarreal,es La Liga,31,1678,18.6,21,10,2,6,4,10,6,0,0,0,MFFW,540ec57b,Rotational Player
1016,Adam Hložek,6,2024-2025,22,cz CZE,Hoffenheim,de Bundesliga,18,1309,14.5,16,2,0,6,2,8,6,0,0,0,FWMF,5521f419,Rotational Player
1017,Tommaso Pobega,6,2020-2021,21,it ITA,Spezia,it Serie A,20,1229,13.7,17,3,12,6,0,6,6,0,0,0,MF,55a1cac2,Rotational Player
1018,Youri Tielemans,6,2021-2022,24,be BEL,Leicester City,eng Premier League,32,2631,29.2,29,3,1,6,4,10,4,2,2,0,MF,56f7a928,Full Starter
1019,Youri Tielemans,6,2020-2021,23,be BEL,Leicester City,eng Premier League,38,3357,37.3,37,1,0,6,4,10,4,2,2,0,MF,56f7a928,Full Starter
1020,Ben Brereton,6,2023-2024,24,cl CHI,2 Teams,2 Comps,28,1375,15.3,16,12,6,6,1,7,5,1,1,0,FWMF,57827369,Rotational Player
1021,Nicolas Pépé,6,2022-2023,27,ci CIV,2 Teams,2 Comps,18,1495,16.6,17,1,3,6,0,6,3,3,3,0,FWMF,57e3f0c7,Rotational Player
1022,Saïd Benrahma,6,2022-2023,26,dz ALG,West Ham,eng Premier League,35,2069,23.0,22,13,3,6,3,9,2,4,4,0,FWMF,5a04fd92,Rotational Player
1023,Francesco Caputo,6,2022-2023,34,it ITA,2 Teams,it Serie A,36,2802,31.1,33,3,0,6,4,10,4,2,2,0,FW,5bd72174,Rotational Player
1024,Teddy Teuma,6,2023-2024,29,mt MLT,Reims,fr Ligue 1,28,2113,23.5,25,3,0,6,3,9,5,1,1,0,MF,5c26ca51,Rotational Player
1025,Patrick Ciurria,6,2022-2023,27,it ITA,Monza,it Serie A,36,2753,30.6,31,5,2,6,5,11,6,0,0,0,DFMF,5de3866c,Full Starter
1026,Moses Simon,6,2020-2021,25,ng NGA,Nantes,fr Ligue 1,33,2324,25.8,28,5,0,6,5,11,5,1,1,0,FWMF,5f3eaaf5,Rotational Player
1027,Moses Simon,6,2021-2022,26,ng NGA,Nantes,fr Ligue 1,30,2332,25.9,29,1,2,6,8,14,6,0,0,0,FWMF,5f3eaaf5,Rotational Player
1028,Andrej Kramarić,6,2021-2022,30,hr CRO,Hoffenheim,de Bundesliga,32,2707,30.1,30,2,0,6,9,15,6,0,0,0,FWMF,603cb947,Rotational Player
1029,Yannick Gerhardt,6,2022-2023,28,de GER,Wolfsburg,de Bundesliga,29,1866,20.7,22,7,0,6,4,10,6,0,0,0,MF,62ab9184,Rotational Player
1030,Marvin Ducksch,6,2024-2025,30,de GER,Werder Bremen,de Bundesliga,19,1558,17.3,19,0,0,6,7,13,5,1,1,0,FW,638a4d71,Full Starter
1031,Borja Mayoral,6,2021-2022,24,es ESP,2 Teams,2 Comps,23,1140,12.7,12,11,11,6,1,7,5,1,1,0,FWDF,64e8ed6d,Rotational Player
1032,Radamel Falcao,6,2021-2022,35,co COL,Rayo Vallecano,es La Liga,22,838,9.3,8,14,4,6,0,6,6,0,0,0,FW,66116290,Bench Player
1033,Josip Iličić,6,2020-2021,32,si SVN,Atalanta,it Serie A,28,1526,17.0,17,11,5,6,9,15,4,2,2,0,MFFW,68252d6d,Rotational Player
1034,Nicolò Barella,6,2022-2023,25,it ITA,Inter,it Serie A,35,2613,29.0,31,4,2,6,6,12,6,0,0,0,MF,6928979a,Full Starter
1035,Iñaki Williams,6,2020-2021,26,gh GHA,Athletic Club,es La Liga,38,2387,26.5,27,11,0,6,6,12,5,1,1,0,FW,6a99e0b1,Full Starter
1036,Gorka Guruzeta,6,2022-2023,25,es ESP,Athletic Club,es La Liga,30,1421,15.8,17,13,8,6,1,7,6,0,0,0,FW,6b5ea2f4,Rotational Player
1037,Steffen Tigges,6,2022-2023,24,de GER,Köln,de Bundesliga,30,1596,17.7,17,13,1,6,1,7,6,0,0,0,FW,6b8887c2,Bench Player
1038,Giacomo Raspadori,6,2020-2021,20,it ITA,Sassuolo,it Serie A,27,1232,13.7,13,14,8,6,0,6,6,0,0,0,FWMF,6e058f06,Rotational Player
1039,Ruben Vargas,6,2020-2021,21,ch SUI,Augsburg,de Bundesliga,30,1612,17.9,18,12,1,6,3,9,6,0,0,0,MFFW,6ecbddf6,Rotational Player
1040,Douglas Luiz,6,2022-2023,24,br BRA,Aston Villa,eng Premier League,37,2927,32.5,33,4,1,6,6,12,6,0,0,0,MF,6f7d826d,Full Starter
1041,James Rodríguez,6,2020-2021,29,co COL,Everton,eng Premier League,23,1764,19.6,21,2,1,6,4,10,6,0,0,0,FWMF,715bf047,Rotational Player
1042,Alexis Claude-Maurice,6,2024-2025,26,fr FRA,Augsburg,de Bundesliga,13,885,9.8,10,3,3,6,1,7,6,0,0,0,MFFW,741418c3,Rotational Player
1043,Romain Faivre,6,2020-2021,22,fr FRA,Brest,fr Ligue 1,36,2891,32.1,33,3,0,6,5,11,5,1,1,0,MFFW,745ca0a3,Rotational Player
1044,Robin Quaison,6,2020-2021,26,se SWE,Mainz 05,de Bundesliga,28,1476,16.4,18,10,2,6,2,8,5,1,1,0,FWMF,74c7c2db,Rotational Player
1045,Gylfi Sigurðsson,6,2020-2021,30,is ISL,Everton,eng Premier League,36,2253,25.0,24,12,2,6,5,11,3,3,4,1,MFFW,76dd1480,Rotational Player
1046,Kristian Thorstvedt,6,2023-2024,24,no NOR,Sassuolo,it Serie A,34,2397,26.6,30,4,3,6,1,7,6,0,0,0,MF,76ff8d0d,Full Starter
1047,Matteo Pessina,6,2023-2024,26,it ITA,Monza,it Serie A,37,3222,35.8,37,0,0,6,3,9,2,4,5,1,MF,780e3631,Full Starter
1048,Oliver McBurnie,6,2023-2024,27,sct SCO,Sheffield Utd,eng Premier League,21,1280,14.2,15,6,3,6,3,9,4,2,2,0,FW,78b8ac63,Rotational Player
1049,Jarrod Bowen,6,2022-2023,25,eng ENG,West Ham,eng Premier League,38,3233,35.9,36,2,0,6,5,11,5,1,2,1,FWMF,79c84d1c,Full Starter
1050,Florian Sotoca,6,2021-2022,30,fr FRA,Lens,fr Ligue 1,35,2480,27.6,28,7,1,6,4,10,4,2,2,0,FWMF,7a42d0df,Full Starter
1051,Ademola Lookman,6,2021-2022,23,ng NGA,Leicester City,eng Premier League,26,1453,16.1,16,10,7,6,0,6,6,0,0,0,FWMF,7c104bb7,Rotational Player
1052,Christopher Nkunku,6,2020-2021,22,fr FRA,RB Leipzig,de Bundesliga,28,1892,21.0,19,9,0,6,6,12,6,0,0,0,FWMF,7c56da38,Rotational Player
1053,Nick Woltemade,6,2024-2025,22,de GER,Stuttgart,de Bundesliga,14,689,7.7,7,7,5,6,1,7,4,2,2,0,FWMF,7ca196eb,Bench Player
1054,Gaëtan Laborde,6,2024-2025,30,fr FRA,Nice,fr Ligue 1,13,708,7.9,7,6,0,6,2,8,4,2,2,0,FW,7cdda3bf,Full Starter
1055,Iago Aspas,6,2024-2025,36,es ESP,Celta Vigo,es La Liga,16,1206,13.4,13,3,1,6,3,9,4,2,3,1,FWMF,7dcf86f6,Full Starter
1056,Florent Mollet,6,2021-2022,29,fr FRA,Montpellier,fr Ligue 1,35,2630,29.2,32,3,1,6,2,8,6,0,0,0,FWMF,7e82a78f,Full Starter
1057,Stefan Posch,6,2022-2023,25,at AUT,2 Teams,2 Comps,31,2550,28.3,31,0,5,6,2,8,6,0,0,0,DF,7f609bfc,Full Starter
1058,Daniel Podence,6,2022-2023,26,pt POR,Wolves,eng Premier League,32,1771,19.7,20,12,3,6,0,6,6,0,0,0,FWMF,7fcc71d8,Rotational Player
1059,Pablo Fornals,6,2021-2022,25,es ESP,West Ham,eng Premier League,36,2795,31.1,32,4,0,6,3,9,6,0,0,0,FWMF,82927de4,Rotational Player
1060,Lucas Alario,6,2021-2022,28,ar ARG,Leverkusen,de Bundesliga,27,655,7.3,5,22,2,6,0,6,6,0,1,1,FW,834d0be5,Bench Player
1061,Lee Kang-in,6,2024-2025,23,kr KOR,Paris S-G,fr Ligue 1,19,1117,12.4,12,7,0,6,3,9,6,0,0,0,FWMF,8455ad90,Rotational Player
1062,Lee Kang-in,6,2022-2023,21,kr KOR,Mallorca,es La Liga,36,2823,31.4,33,3,0,6,6,12,6,0,0,0,MFFW,8455ad90,Rotational Player
1063,Loïs Openda,6,2024-2025,24,be BEL,RB Leipzig,de Bundesliga,18,1507,16.7,17,1,0,6,5,11,6,0,1,1,FWMF,8652a85c,Full Starter
1064,Lázaro,6,2022-2023,20,br BRA,Almería,es La Liga,19,716,8.0,7,12,16,6,0,6,6,0,0,0,FWMF,86ff856b,Bench Player
1065,Sergio Camello,6,2022-2023,21,es ESP,Rayo Vallecano,es La Liga,38,2401,26.7,27,11,0,6,5,11,6,0,0,0,FW,873619c6,Rotational Player
1066,Zuriko Davitashvili,6,2024-2025,23,ge GEO,Saint-Étienne,fr Ligue 1,18,1542,17.1,18,0,0,6,2,8,5,1,1,0,MFFW,88b4d2e3,Rotational Player
1067,Anthony Martial,6,2022-2023,26,fr FRA,Manchester Utd,eng Premier League,21,978,10.9,11,10,0,6,2,8,5,1,1,0,FW,8b788c01,Rotational Player
1068,Carlos Augusto,6,2022-2023,23,br BRA,Monza,it Serie A,35,3083,34.3,35,0,0,6,5,11,6,0,0,0,DF,8d3cd59d,Full Starter
1069,Alexander Isak,6,2021-2022,21,se SWE,Real Sociedad,es La Liga,32,2140,23.8,26,6,1,6,2,8,4,2,2,0,FW,8e92be30,Rotational Player
1070,Rodrygo,6,2024-2025,23,br BRA,Real Madrid,es La Liga,18,1199,13.3,14,4,0,6,5,11,6,0,0,0,FW,8f5e92a6,Rotational Player
1071,Manolo Gabbiadini,6,2021-2022,29,it ITA,Sampdoria,it Serie A,18,1140,12.7,15,3,0,6,2,8,6,0,0,0,FWMF,8f866fe8,Rotational Player
1072,Álvaro García,6,2023-2024,30,es ESP,Rayo Vallecano,es La Liga,32,2475,27.5,30,2,0,6,1,7,6,0,0,0,FWMF,90bbd822,Full Starter
1073,John McGinn,6,2023-2024,28,sct SCO,Aston Villa,eng Premier League,35,2999,33.3,35,0,0,6,4,10,6,0,0,0,MFFW,90f91999,Full Starter
1074,Nicolò Cambiaghi,6,2022-2023,21,it ITA,Empoli,it Serie A,28,1285,14.3,12,16,3,6,1,7,6,0,0,0,FWMF,91ff775f,Rotational Player
1075,Kamory Doumbia,6,2023-2024,20,ml MLI,2 Teams,fr Ligue 1,25,879,9.8,7,18,2,6,5,11,6,0,0,0,MF,9226aa22,Bench Player
1076,Son Heung-min,6,2024-2025,32,kr KOR,Tottenham,eng Premier League,20,1495,16.6,18,2,0,6,6,12,6,0,1,1,FW,92e7e919,Full Starter
1077,Vincent Sierro,6,2023-2024,27,ch SUI,Toulouse,fr Ligue 1,30,2261,25.1,25,5,2,6,2,8,2,4,5,1,MF,92ffb8f9,Rotational Player
1078,Dominik Szoboszlai,6,2022-2023,21,hu HUN,RB Leipzig,de Bundesliga,31,2444,27.2,28,3,0,6,8,14,5,1,1,0,MFFW,934e1968,Rotational Player
1079,Dominik Szoboszlai,6,2021-2022,20,hu HUN,RB Leipzig,de Bundesliga,31,1543,17.1,15,16,3,6,8,14,6,0,1,1,MFFW,934e1968,Rotational Player
1080,Florian Kainz,6,2022-2023,29,at AUT,Köln,de Bundesliga,32,2344,26.0,31,1,0,6,10,16,3,3,3,0,MFFW,94c18565,Full Starter
1081,Simone Zaza,6,2020-2021,29,it ITA,Torino,it Serie A,29,1491,16.6,15,14,3,6,0,6,6,0,0,0,FW,9592289a,Rotational Player
1082,Manu Trigueros,6,2021-2022,29,es ESP,Villarreal,es La Liga,35,2178,24.2,27,8,1,6,4,10,6,0,0,0,MFFW,963829d0,Full Starter
1083,Mason Mount,6,2020-2021,21,eng ENG,Chelsea,eng Premier League,36,2890,32.1,32,4,1,6,5,11,5,1,1,0,MF,9674002f,Full Starter
1084,Armando Broja,6,2021-2022,19,al ALB,Southampton,eng Premier League,32,1975,21.9,21,11,0,6,0,6,6,0,0,0,FW,97220da2,Rotational Player
1085,Pablo Sarabia,6,2020-2021,28,es ESP,Paris S-G,fr Ligue 1,27,1320,14.7,13,14,3,6,4,10,6,0,0,0,FWMF,9744ff80,Rotational Player
1086,Emil Forsberg,6,2022-2023,30,se SWE,RB Leipzig,de Bundesliga,30,1482,16.5,16,14,3,6,4,10,4,2,2,0,MFFW,9a2e0ccc,Rotational Player
1087,Emil Forsberg,6,2021-2022,29,se SWE,RB Leipzig,de Bundesliga,31,1706,19.0,20,11,0,6,2,8,2,4,4,0,MF,9a2e0ccc,Rotational Player
1088,Kirian Rodríguez,6,2023-2024,27,es ESP,Las Palmas,es La Liga,37,3211,35.7,36,1,0,6,2,8,6,0,0,0,MF,9b130479,Full Starter
1089,Amad Diallo,6,2024-2025,22,ci CIV,Manchester Utd,eng Premier League,21,1504,16.7,16,5,2,6,6,12,6,0,0,0,FWMF,9dc96f10,Rotational Player
1090,Ferrán Torres,6,2021-2022,21,es ESP,2 Teams,2 Comps,22,1715,19.1,21,1,3,6,5,11,5,1,1,0,FW,9e1035f8,Rotational Player
1091,Felipe Anderson,6,2021-2022,28,br BRA,Lazio,it Serie A,38,2888,32.1,33,5,0,6,8,14,6,0,0,0,FW,9f1893b9,Full Starter
1092,Farid Boulaya,6,2020-2021,27,dz ALG,Metz,fr Ligue 1,33,2815,31.3,32,1,1,6,8,14,5,1,2,1,MFFW,a0791826,Rotational Player
1093,Lucas Ocampos,6,2021-2022,27,ar ARG,Sevilla,es La Liga,30,2125,23.6,23,7,1,6,4,10,6,0,0,0,FW,a08b974a,Rotational Player
1094,Sean Longstaff,6,2023-2024,25,eng ENG,Newcastle Utd,eng Premier League,35,2747,30.5,30,5,0,6,2,8,6,0,0,0,MF,a2b105e0,Full Starter
1095,Justin Njinmah,6,2023-2024,22,de GER,Werder Bremen,de Bundesliga,24,1016,11.3,10,14,2,6,2,8,6,0,0,0,FW,a45241d5,Rotational Player
1096,Patrick Cutrone,6,2024-2025,26,it ITA,Como,it Serie A,22,1519,16.9,17,5,0,6,2,8,6,0,1,1,FW,a4fe8cda,Rotational Player
1097,Piotr Zieliński,6,2021-2022,27,pl POL,Napoli,it Serie A,35,2086,23.2,26,9,1,6,5,11,6,0,0,0,MF,a5296e55,Full Starter
1098,Houssem Aouar,6,2021-2022,23,dz ALG,Lyon,fr Ligue 1,36,2504,27.8,29,7,0,6,4,10,6,0,0,0,MFFW,a5db0bec,Rotational Player
1099,Nuno Tavares,6,2022-2023,22,pt POR,Marseille,fr Ligue 1,31,2349,26.1,23,8,1,6,0,6,6,0,0,0,DFMF,a65c844b,Rotational Player
1100,Paco Alcácer,6,2020-2021,26,es ESP,Villarreal,es La Liga,27,1544,17.2,19,8,2,6,4,10,5,1,2,1,FW,a7a9d95a,Rotational Player
1101,Éderson,6,2023-2024,24,br BRA,Atalanta,it Serie A,36,2869,31.9,32,4,1,6,1,7,6,0,0,0,MF,a9202def,Full Starter
1102,Bryan Zaragoza,6,2023-2024,22,es ESP,2 Teams,2 Comps,28,1821,20.2,19,9,6,6,2,8,5,1,1,0,MFFW,a96103b2,Rotational Player
1103,Luuk de Jong,6,2021-2022,30,nl NED,2 Teams,es La Liga,21,654,7.3,6,15,14,6,0,6,6,0,0,0,FW,abb3bb95,Rotational Player
1104,Érik Lamela,6,2022-2023,30,ar ARG,Sevilla,es La Liga,32,1844,20.5,20,12,2,6,0,6,6,0,0,0,FWMF,abe66106,Rotational Player
1105,Michail Antonio,6,2023-2024,33,jm JAM,West Ham,eng Premier League,26,1695,18.8,21,5,0,6,2,8,6,0,0,0,FW,ac05f970,Rotational Player
1106,Moussa Diaby,6,2023-2024,24,fr FRA,Aston Villa,eng Premier League,38,2174,24.2,25,13,0,6,8,14,6,0,0,0,FWMF,aeed5c06,Full Starter
1107,Tijjani Reijnders,6,2024-2025,26,nl NED,Milan,it Serie A,20,1620,18.0,19,1,0,6,2,8,6,0,0,0,MF,afb61630,Full Starter
1108,Nico Williams,6,2022-2023,20,es ESP,Athletic Club,es La Liga,36,2656,29.5,32,4,0,6,4,10,6,0,0,0,FW,afdc14d7,Full Starter
1109,Jack Grealish,6,2020-2021,24,eng ENG,Aston Villa,eng Premier League,26,2185,24.3,24,2,0,6,10,16,6,0,0,0,FWMF,b0b4fd3e,Rotational Player
1110,Victor Boniface,6,2024-2025,23,ng NGA,Leverkusen,de Bundesliga,10,658,7.3,8,2,1,6,1,7,6,0,1,1,FW,b146275b,Rotational Player
1111,Ousmane Dembélé,6,2020-2021,23,fr FRA,Barcelona,es La Liga,30,1774,19.7,19,11,3,6,3,9,6,0,0,0,FW,b19db005,Rotational Player
1112,Jonathan Bamba,6,2022-2023,26,ci CIV,Lille,fr Ligue 1,34,2783,30.9,32,2,0,6,7,13,6,0,0,0,FW,b2bd0f6c,Full Starter
1113,Jonathan Bamba,6,2020-2021,24,ci CIV,Lille,fr Ligue 1,38,2985,33.2,34,4,0,6,9,15,6,0,0,0,MF,b2bd0f6c,Full Starter
1114,Raheem Sterling,6,2022-2023,27,eng ENG,Chelsea,eng Premier League,28,1891,21.0,23,5,1,6,3,9,6,0,0,0,FWMF,b400bde0,Rotational Player
1115,Raúl García,6,2021-2022,35,es ESP,Athletic Club,es La Liga,35,1802,20.0,24,11,1,6,2,8,6,0,1,1,FW,b418dbd4,Rotational Player
1116,Raúl Jiménez,6,2021-2022,30,mx MEX,Wolves,eng Premier League,34,2631,29.2,30,4,0,6,4,10,5,1,1,0,FW,b561db50,Rotational Player
1117,Evann Guessand,6,2023-2024,22,ci CIV,Nice,fr Ligue 1,34,1553,17.3,14,20,0,6,0,6,4,2,2,0,FW,b73f17f8,Rotational Player
1118,Samuel Chukwueze,6,2022-2023,23,ng NGA,Villarreal,es La Liga,37,2339,26.0,27,10,1,6,5,11,6,0,0,0,FWMF,b8a642fc,Rotational Player
1119,Rafa Mir,6,2022-2023,25,es ESP,Sevilla,es La Liga,26,1298,14.4,16,10,12,6,0,6,6,0,0,0,FW,bbf5c11b,Rotational Player
1120,Alassane Pléa,6,2020-2021,27,fr FRA,Gladbach,de Bundesliga,29,1803,20.0,19,10,1,6,1,7,6,0,0,0,FW,bc6bd723,Rotational Player
1121,Alassane Pléa,6,2024-2025,31,fr FRA,Gladbach,de Bundesliga,18,1198,13.3,16,2,0,6,2,8,6,0,0,0,MFFW,bc6bd723,Rotational Player
1122,Oihan Sancet,6,2021-2022,21,es ESP,Athletic Club,es La Liga,27,1422,15.8,16,11,0,6,4,10,6,0,0,0,FW,bdb624a3,Rotational Player
1123,Nabil Fekir,6,2021-2022,28,fr FRA,Betis,es La Liga,34,2794,31.0,33,1,1,6,8,14,6,0,0,0,MF,bece776f,Full Starter
1124,Joelinton,6,2022-2023,25,br BRA,Newcastle Utd,eng Premier League,32,2661,29.6,30,2,1,6,1,7,6,0,0,0,MFFW,c17bfb65,Full Starter
1125,Zakaria Aboukhlal,6,2024-2025,24,ma MAR,Toulouse,fr Ligue 1,19,1510,16.8,18,1,0,6,2,8,5,1,2,1,MFFW,c2a6033c,Rotational Player
1126,Michael Olise,6,2024-2025,22,fr FRA,Bayern Munich,de Bundesliga,19,1175,13.1,14,5,0,6,6,12,6,0,0,0,FWMF,c4486bac,Rotational Player
1127,Antonio Puertas,6,2021-2022,29,es ESP,Granada,es La Liga,33,2261,25.1,25,8,5,6,1,7,6,0,0,0,MFFW,c77a8043,Rotational Player
1128,Fabián Orellana,6,2020-2021,34,cl CHI,Valladolid,es La Liga,30,2138,23.8,27,3,1,6,2,8,2,4,4,0,MFFW,c90977db,Full Starter
1129,Noah Okafor,6,2023-2024,23,ch SUI,Milan,it Serie A,28,887,9.9,6,22,4,6,2,8,6,0,0,0,FWMF,ca607d59,Bench Player
1130,Kasper Dolberg,6,2021-2022,23,dk DEN,Nice,fr Ligue 1,26,1492,16.6,19,7,5,6,2,8,4,2,2,0,FW,cc83b74d,Rotational Player
1131,Kasper Dolberg,6,2020-2021,22,dk DEN,Nice,fr Ligue 1,25,1928,21.4,21,4,0,6,2,8,4,2,2,0,FW,cc83b74d,Rotational Player
1132,Leon Goretzka,6,2023-2024,28,de GER,Bayern Munich,de Bundesliga,30,2241,24.9,25,5,0,6,7,13,6,0,0,0,MF,cc86b9a3,Rotational Player
1133,Rocco Reitz,6,2023-2024,21,de GER,Gladbach,de Bundesliga,34,2136,23.7,24,10,0,6,3,9,6,0,0,0,MF,cc971106,Rotational Player
1134,Danny Welbeck,6,2020-2021,29,eng ENG,Brighton,eng Premier League,24,1545,17.2,17,7,2,6,1,7,6,0,1,1,FW,ce5143da,Rotational Player
1135,Danny Welbeck,6,2021-2022,30,eng ENG,Brighton,eng Premier League,25,1478,16.4,15,10,1,6,2,8,6,0,0,0,FWMF,ce5143da,Rotational Player
1136,Danny Welbeck,6,2022-2023,31,eng ENG,Brighton,eng Premier League,31,1854,20.6,21,10,1,6,3,9,6,0,0,0,FW,ce5143da,Rotational Player
1137,Danny Welbeck,6,2024-2025,33,eng ENG,Brighton,eng Premier League,17,1283,14.3,15,2,0,6,2,8,6,0,0,0,FW,ce5143da,Rotational Player
1138,Elif Elmas,6,2022-2023,22,mk MKD,Napoli,it Serie A,36,1627,18.1,14,22,1,6,3,9,5,1,1,0,FWMF,cf007308,Rotational Player
1139,Ritsu Doan,6,2024-2025,26,jp JPN,Freiburg,de Bundesliga,19,1596,17.7,19,0,0,6,3,9,6,0,0,0,FWMF,d01bbb6f,Full Starter
1140,Daniel Caligiuri,6,2020-2021,32,it ITA,Augsburg,de Bundesliga,33,2665,29.6,31,2,0,6,4,10,4,2,3,1,MFFW,d1273f09,Full Starter
1141,Abdón Prats,6,2023-2024,30,es ESP,Mallorca,es La Liga,34,1270,14.1,11,23,4,6,1,7,6,0,0,0,FWMF,d1b060e2,Bench Player
1142,Yussuf Poulsen,6,2021-2022,27,dk DEN,RB Leipzig,de Bundesliga,25,1079,12.0,12,13,1,6,0,6,6,0,0,0,FWMF,d2416c2e,Rotational Player
1143,Daniele Verde,6,2020-2021,24,it ITA,Spezia,it Serie A,21,980,10.9,12,9,6,6,1,7,6,0,0,0,FW,d3298c99,Rotational Player
1144,Andy Delort,6,2022-2023,30,dz ALG,2 Teams,fr Ligue 1,26,1250,13.9,15,11,0,6,1,7,3,3,3,0,FW,d33c706e,Rotational Player
1145,Lucas Boyé,6,2023-2024,27,ar ARG,Granada,es La Liga,31,2541,28.2,30,1,0,6,3,9,6,0,0,0,FW,d49f3e6b,Full Starter
1146,Andrea Belotti,6,2023-2024,29,it ITA,2 Teams,it Serie A,29,1628,18.1,17,12,8,6,2,8,6,0,0,0,FW,d705ba44,Rotational Player
1147,Lionel Messi,6,2021-2022,34,ar ARG,Paris S-G,fr Ligue 1,26,2153,23.9,24,2,0,6,14,20,6,0,0,0,FWMF,d70ce98e,Full Starter
1148,Mattia Zaccagni,6,2021-2022,26,it ITA,2 Teams,it Serie A,31,2056,22.8,23,8,0,6,5,11,5,1,1,0,MF,d85c238b,Full Starter
1149,Mattia Zaccagni,6,2024-2025,29,it ITA,Lazio,it Serie A,19,1487,16.5,18,1,0,6,3,9,4,2,2,0,FW,d85c238b,Full Starter
1150,Mattia Zaccagni,6,2023-2024,28,it ITA,Lazio,it Serie A,28,1956,21.7,24,4,0,6,1,7,6,0,0,0,FWMF,d85c238b,Full Starter
1151,Franck Honorat,6,2022-2023,25,fr FRA,Brest,fr Ligue 1,33,2535,28.2,29,4,0,6,5,11,6,0,0,0,FWMF,db7849ca,Full Starter
1152,Junya Ito,6,2022-2023,29,jp JPN,Reims,fr Ligue 1,35,2916,32.4,34,1,0,6,5,11,6,0,0,0,FW,dbd3a428,Full Starter
1153,Jadon Sancho,6,2022-2023,22,eng ENG,Manchester Utd,eng Premier League,26,1686,18.7,21,5,4,6,3,9,6,0,0,0,FWMF,dbf053da,Rotational Player
1154,Matheus Cunha,6,2021-2022,22,br BRA,2 Teams,2 Comps,30,1127,12.5,9,21,1,6,5,11,6,0,0,0,FW,dc62b55d,Rotational Player
1155,Cyriel Dessers,6,2022-2023,27,ng NGA,Cremonese,it Serie A,26,1587,17.6,19,7,2,6,1,7,6,0,1,1,FW,dcb38abe,Rotational Player
1156,Yannick Carrasco,6,2021-2022,27,be BEL,Atlético Madrid,es La Liga,34,2583,28.7,28,6,0,6,6,12,4,2,2,0,FWMF,de39485a,Full Starter
1157,Yannick Carrasco,6,2020-2021,26,be BEL,Atlético Madrid,es La Liga,30,2179,24.2,25,5,1,6,10,16,6,0,0,0,DFMF,de39485a,Full Starter
1158,Dejan Kulusevski,6,2021-2022,21,se SWE,2 Teams,2 Comps,38,2033,22.6,19,19,2,6,11,17,6,0,0,0,MFFW,df3cda47,Rotational Player
1159,Dejan Kulusevski,6,2024-2025,24,se SWE,Tottenham,eng Premier League,23,1860,20.7,21,2,0,6,4,10,6,0,0,0,MFFW,df3cda47,Rotational Player
1160,Riccardo Orsolini,6,2021-2022,24,it ITA,Bologna,it Serie A,29,1785,19.8,21,8,8,6,3,9,4,2,2,0,FWMF,e14ec482,Rotational Player
1161,Kevin De Bruyne,6,2020-2021,29,be BEL,Manchester City,eng Premier League,25,1997,22.2,23,2,4,6,12,18,4,2,3,1,MF,e46012d4,Rotational Player
1162,Taiwo Awoniyi,6,2023-2024,25,ng NGA,Nott'ham Forest,eng Premier League,20,1042,11.6,12,8,0,6,3,9,6,0,0,0,FW,e5478b87,Rotational Player
1163,Mario Pašalić,6,2023-2024,28,hr CRO,Atalanta,it Serie A,34,2051,22.8,23,11,4,6,6,12,4,2,2,0,MF,e599253a,Rotational Player
1164,Mario Pašalić,6,2020-2021,25,hr CRO,Atalanta,it Serie A,25,1122,12.5,10,15,2,6,2,8,6,0,0,0,MF,e599253a,Rotational Player
1165,Musa Barrow,6,2021-2022,22,gm GAM,Bologna,it Serie A,34,2134,23.7,25,9,1,6,6,12,6,0,0,0,FWMF,e5bf73f3,Full Starter
1166,Dominic Solanke,6,2022-2023,24,eng ENG,Bournemouth,eng Premier League,33,2860,31.8,32,1,0,6,7,13,6,0,0,0,FWMF,e77dc3b2,Full Starter
1167,Fábio Silva,6,2024-2025,22,pt POR,Las Palmas,es La Liga,16,1203,13.4,15,1,0,6,2,8,5,1,2,1,FW,e7aa9d7c,Rotational Player
1168,Ruben Loftus-Cheek,6,2023-2024,27,eng ENG,Milan,it Serie A,29,2068,23.0,26,3,2,6,1,7,6,0,0,0,MF,e97fd090,Full Starter
1169,Joel Pohjanpalo,6,2024-2025,29,fi FIN,Venezia,it Serie A,19,1517,16.9,18,1,0,6,0,6,3,3,4,1,FW,ea003d07,Rotational Player
1170,Joel Pohjanpalo,6,2020-2021,25,fi FIN,2 Teams,de Bundesliga,20,857,9.5,10,10,1,6,0,6,6,0,0,0,FW,ea003d07,Rotational Player
1171,Moanes Dabbur,6,2022-2023,30,il ISR,Hoffenheim,de Bundesliga,21,933,10.4,8,13,6,6,2,8,6,0,0,0,FW,eac044ad,Rotational Player
1172,Fidel,6,2020-2021,30,es ESP,Elche,es La Liga,30,2396,26.6,28,2,0,6,3,9,4,2,3,1,MFDF,eb82b6f1,Full Starter
1173,Santiago Castro,6,2024-2025,19,ar ARG,Bologna,it Serie A,21,1492,16.6,18,3,0,6,4,10,6,0,1,1,FW,ee5565ae,Rotational Player
1174,Lewis Ferguson,6,2023-2024,23,sct SCO,Bologna,it Serie A,31,2712,30.1,31,0,0,6,3,9,6,0,0,0,MF,ee64a822,Full Starter
1175,Luis Javier Suárez,6,2023-2024,25,co COL,Almería,es La Liga,15,917,10.2,10,5,0,6,0,6,5,1,1,0,FW,eeba07f8,Rotational Player
1176,Stevan Jovetić,6,2020-2021,30,me MNE,Monaco,fr Ligue 1,29,802,8.9,6,23,3,6,0,6,6,0,1,1,FWMF,f36c432f,Bench Player
1177,Stevan Jovetić,6,2021-2022,31,me MNE,Hertha BSC,de Bundesliga,18,1017,11.3,13,5,3,6,1,7,6,0,0,0,FWMF,f36c432f,Bench Player
1178,Luis Henrique,6,2024-2025,22,br BRA,Marseille,fr Ligue 1,19,1475,16.4,17,2,0,6,4,10,6,0,0,0,DFFW,f36d5624,Rotational Player
1179,Nedim Bajrami,6,2021-2022,22,al ALB,Empoli,it Serie A,35,2054,22.8,23,12,3,6,5,11,3,3,3,0,MFFW,f42d6c13,Rotational Player
1180,Tammy Abraham,6,2020-2021,22,eng ENG,Chelsea,eng Premier League,22,1040,11.6,12,10,8,6,1,7,6,0,0,0,FW,f586779e,Rotational Player
1181,Marco Richter,6,2022-2023,24,de GER,Hertha BSC,de Bundesliga,29,1836,20.4,21,8,1,6,5,11,6,0,0,0,MFFW,f972644c,Rotational Player
1182,Emmanuel Gyasi,6,2021-2022,27,gh GHA,Spezia,it Serie A,36,3035,33.7,35,1,0,6,0,6,6,0,0,0,FWMF,f9758dae,Full Starter
1183,Mounaim El Idrissy,6,2022-2023,23,fr FRA,Ajaccio,fr Ligue 1,32,2497,27.7,30,2,1,6,0,6,6,0,0,0,FW,fb0ee44e,Full Starter
1184,Lovro Majer,6,2021-2022,23,hr CRO,Rennes,fr Ligue 1,29,1832,20.4,21,8,0,6,8,14,6,0,0,0,MFFW,fc46aab1,Rotational Player
1185,Jeremie Boga,6,2023-2024,26,ci CIV,Nice,fr Ligue 1,28,1998,22.2,24,4,0,6,6,12,6,0,0,0,FW,fe012aca,Rotational Player
1186,Casper Tengstedt,6,2024-2025,24,dk DEN,Hellas Verona,it Serie A,19,1267,14.1,17,2,2,6,1,7,5,1,1,0,FW,ff2fb007,Rotational Player
1187,Jeremy Doku,6,2022-2023,20,be BEL,Rennes,fr Ligue 1,29,1291,14.3,13,16,1,6,2,8,6,0,0,0,MFFW,fffea3e5,Rotational Player
1188,Marko Arnautović,5,2023-2024,34,at AUT,Inter,it Serie A,27,801,8.9,5,22,3,5,3,8,5,0,0,0,FW,00459419,Rotational Player
1189,Przemysław Frankowski,5,2022-2023,27,pl POL,Lens,fr Ligue 1,37,2833,31.5,31,6,0,5,3,8,2,3,3,0,DFMF,00a8d210,Rotational Player
1190,Mohamed Lamine Bayo,5,2023-2024,25,gn GUI,Le Havre,fr Ligue 1,22,1389,15.4,16,6,1,5,1,6,3,2,2,0,FW,01870104,Rotational Player
1191,Nicolás Paz,5,2024-2025,19,ar ARG,Como,it Serie A,20,1470,16.3,16,4,1,5,3,8,5,0,1,1,MFFW,01bb93d5,Rotational Player
1192,Weston McKennie,5,2020-2021,21,us USA,Juventus,it Serie A,34,1702,18.9,18,16,2,5,2,7,5,0,0,0,MF,01c3aff5,Rotational Player
1193,Jaime Mata,5,2020-2021,31,es ESP,Getafe,es La Liga,33,2037,22.6,23,10,2,5,0,5,4,1,2,1,FW,02319ad7,Rotational Player
1194,Jaime Mata,5,2023-2024,34,es ESP,Getafe,es La Liga,35,1787,19.9,22,13,1,5,1,6,5,0,0,0,FWMF,02319ad7,Rotational Player
1195,Abdoulaye Doucouré,5,2022-2023,29,ml MLI,Everton,eng Premier League,25,1533,17.0,17,8,4,5,2,7,5,0,0,0,MF,02b29014,Full Starter
1196,Simone Verdi,5,2022-2023,30,it ITA,Hellas Verona,it Serie A,24,1096,12.2,12,12,6,5,0,5,4,1,1,0,MFFW,0375723e,Rotational Player
1197,Kingsley Coman,5,2020-2021,24,fr FRA,Bayern Munich,de Bundesliga,29,1752,19.5,23,6,2,5,10,15,5,0,0,0,FWMF,042e8a49,Rotational Player
1198,Raphaël Guerreiro,5,2020-2021,26,pt POR,Dortmund,de Bundesliga,27,2218,24.6,25,2,1,5,10,15,5,0,0,0,DF,048a1cbc,Rotational Player
1199,Mykhailo Mudryk,5,2023-2024,22,ua UKR,Chelsea,eng Premier League,31,1576,17.5,18,13,4,5,2,7,5,0,0,0,FW,049a888d,Rotational Player
1200,Ibrahima Koné,5,2021-2022,22,ml MLI,Lorient,fr Ligue 1,16,732,8.1,6,10,0,5,1,6,5,0,0,0,FW,04bb2b06,Rotational Player
1201,Lorenzo Colombo,5,2022-2023,20,it ITA,Lecce,it Serie A,33,1515,16.8,18,15,4,5,2,7,4,1,2,1,FW,04df29a5,Rotational Player
1202,Lorenzo Colombo,5,2024-2025,22,it ITA,Empoli,it Serie A,22,1566,17.4,19,3,0,5,2,7,4,1,1,0,FWMF,04df29a5,Rotational Player
1203,Youssef En-Nesyri,5,2021-2022,24,ma MAR,Sevilla,es La Liga,23,1277,14.2,15,8,2,5,1,6,4,1,1,0,FW,04e17fd5,Rotational Player
1204,Odsonne Édouard,5,2022-2023,24,fr FRA,Crystal Palace,eng Premier League,35,1803,20.0,20,15,2,5,2,7,5,0,0,0,FW,0562b7f1,Rotational Player
1205,Mats Hummels,5,2020-2021,31,de GER,Dortmund,de Bundesliga,33,2813,31.3,32,1,0,5,0,5,5,0,0,0,DF,05d548d8,Full Starter
1206,Gaetano Castrovilli,5,2020-2021,23,it ITA,Fiorentina,it Serie A,34,2332,25.9,29,5,1,5,3,8,5,0,0,0,MF,0728bebe,Rotational Player
1207,Andrea Pinamonti,5,2022-2023,23,it ITA,Sassuolo,it Serie A,32,2161,24.0,25,7,0,5,0,5,4,1,1,0,FW,08aa9cd1,Full Starter
1208,Federico Valverde,5,2024-2025,26,uy URU,Real Madrid,es La Liga,21,1829,20.3,21,0,0,5,2,7,5,0,0,0,MFDF,0959c2a2,Rotational Player
1209,Carlos Bacca,5,2020-2021,33,co COL,Villarreal,es La Liga,23,786,8.7,9,14,9,5,0,5,5,0,0,0,FW,09a9e921,Bench Player
1210,Antonio Sanabria,5,2023-2024,27,py PAR,Torino,it Serie A,35,2133,23.7,23,12,2,5,0,5,3,2,2,0,FWMF,0a447501,Rotational Player
1211,Breel Embolo,5,2020-2021,23,ch SUI,Gladbach,de Bundesliga,31,1440,16.0,16,15,0,5,2,7,5,0,0,0,FWMF,0b4f388a,Rotational Player
1212,Manu Vallejo,5,2020-2021,23,es ESP,Valencia,es La Liga,30,950,10.6,9,21,8,5,0,5,5,0,0,0,FWMF,0bc4e720,Bench Player
1213,Dodi Lukebakio,5,2020-2021,22,be BEL,Hertha BSC,de Bundesliga,29,1855,20.6,21,8,0,5,5,10,3,2,2,0,FWMF,0c61c77c,Rotational Player
1214,Dodi Lukebakio,5,2023-2024,25,be BEL,Sevilla,es La Liga,23,1125,12.5,12,11,1,5,1,6,5,0,0,0,FWMF,0c61c77c,Rotational Player
1215,Vedat Muriqi,5,2021-2022,27,xk KVX,2 Teams,2 Comps,27,1653,18.4,17,10,12,5,3,8,3,2,2,0,FW,0cadc46d,Rotational Player
1216,Brennan Johnson,5,2023-2024,22,wls WAL,2 Teams,eng Premier League,35,2322,25.8,26,9,0,5,10,15,5,0,0,0,FW,0cd31129,Rotational Player
1217,Chris Führich,5,2022-2023,24,de GER,Stuttgart,de Bundesliga,33,1884,20.9,21,12,0,5,2,7,4,1,1,0,FWMF,0cf778df,Rotational Player
1218,Sandro Tonali,5,2021-2022,21,it ITA,Milan,it Serie A,36,2600,28.9,31,5,1,5,2,7,5,0,0,0,MF,0db169ae,Full Starter
1219,Omar Marmoush,5,2022-2023,23,eg EGY,Wolfsburg,de Bundesliga,33,1476,16.4,15,18,1,5,1,6,5,0,0,0,FW,0e0102eb,Rotational Player
1220,Matthis Abline,5,2023-2024,20,fr FRA,2 Teams,fr Ligue 1,22,1044,11.6,12,10,6,5,0,5,5,0,0,0,FW,0e46fa2f,Rotational Player
1221,Matthis Abline,5,2024-2025,21,fr FRA,Nantes,fr Ligue 1,19,1495,16.6,18,1,0,5,0,5,4,1,1,0,FW,0e46fa2f,Rotational Player
1222,Mathias Jensen,5,2022-2023,26,dk DEN,Brentford,eng Premier League,37,2803,31.1,37,0,0,5,6,11,5,0,0,0,MF,0f134faf,Full Starter
1223,Bobby Reid,5,2020-2021,27,jm JAM,Fulham,eng Premier League,33,2372,26.4,28,5,2,5,2,7,5,0,0,0,MFFW,0f7533cd,Rotational Player
1224,Gaëtan Perrin,5,2024-2025,28,fr FRA,Auxerre,fr Ligue 1,19,1359,15.1,16,3,0,5,4,9,5,0,0,0,MFFW,10dd88f9,Rotational Player
1225,Donyell Malen,5,2021-2022,22,nl NED,Dortmund,de Bundesliga,27,1684,18.7,20,7,0,5,3,8,5,0,0,0,FW,116c35df,Rotational Player
1226,Reece James,5,2021-2022,21,eng ENG,Chelsea,eng Premier League,26,1864,20.7,22,4,1,5,9,14,5,0,0,0,DF,1265a93a,Rotational Player
1227,Álvaro Morata,5,2024-2025,31,es ESP,Milan,it Serie A,16,1099,12.2,13,3,0,5,0,5,5,0,0,0,FWMF,129af0db,Rotational Player
1228,Jamie Leweling,5,2021-2022,20,de GER,Greuther Fürth,de Bundesliga,33,1959,21.8,22,11,0,5,1,6,5,0,0,0,FWMF,13fe7b69,Rotational Player
1229,Daichi Kamada,5,2020-2021,23,jp JPN,Eint Frankfurt,de Bundesliga,32,2356,26.2,28,4,1,5,12,17,5,0,0,0,MF,15b287da,Rotational Player
1230,Hwang Hee-chan,5,2021-2022,25,kr KOR,2 Teams,2 Comps,32,1865,20.7,20,12,1,5,1,6,5,0,0,0,FW,169fd162,Rotational Player
1231,Álex Moreno,5,2021-2022,28,es ESP,Betis,es La Liga,30,2404,26.7,28,2,2,5,3,8,5,0,0,0,DF,16e9d0ea,Rotational Player
1232,Aaron Hickey,5,2021-2022,19,sct SCO,Bologna,it Serie A,36,2820,31.3,34,2,0,5,1,6,5,0,0,0,DF,1780bb4a,Full Starter
1233,Diogo Jota,5,2024-2025,27,pt POR,Liverpool,eng Premier League,13,629,7.0,7,6,1,5,2,7,5,0,0,0,FW,178ae8f8,Rotational Player
1234,Williot Swedberg,5,2023-2024,19,se SWE,Celta Vigo,es La Liga,15,439,4.9,4,11,16,5,0,5,5,0,0,0,FWMF,184fe4b2,Bench Player
1235,Cengiz Ünder,5,2022-2023,25,tr TUR,Marseille,fr Ligue 1,37,2490,27.7,28,9,1,5,4,9,4,1,1,0,MFDF,1880614f,Full Starter
1236,Sofiane Diop,5,2024-2025,24,fr FRA,Nice,fr Ligue 1,15,724,8.0,7,8,0,5,3,8,5,0,0,0,MFFW,19053e31,Rotational Player
1237,Ángel Di María,5,2021-2022,33,ar ARG,Paris S-G,fr Ligue 1,26,1645,18.3,19,7,3,5,7,12,5,0,0,0,FW,19cda00b,Rotational Player
1238,Elvis Rexhbeçaj,5,2020-2021,22,xk KVX,Köln,de Bundesliga,30,1833,20.4,20,10,3,5,2,7,5,0,0,0,MFFW,1ae836b1,Rotational Player
1239,Paul Nebel,5,2024-2025,21,de GER,Mainz 05,de Bundesliga,17,1093,12.1,12,5,2,5,2,7,5,0,0,0,MF,1b6d8083,Rotational Player
1240,Bafodé Diakité,5,2023-2024,22,fr FRA,Lille,fr Ligue 1,21,1696,18.8,19,2,4,5,2,7,5,0,0,0,DF,1bfb6fef,Rotational Player
1241,Roberto Piccoli,5,2024-2025,23,it ITA,Cagliari,it Serie A,22,1817,20.2,22,0,0,5,0,5,4,1,1,0,FW,1cadaf34,Rotational Player
1242,Roberto Piccoli,5,2023-2024,22,it ITA,2 Teams,it Serie A,37,1417,15.7,12,25,0,5,0,5,4,1,1,0,FW,1cadaf34,Rotational Player
1243,Roberto Piccoli,5,2020-2021,19,it ITA,Spezia,it Serie A,20,703,7.8,8,12,12,5,0,5,5,0,0,0,FW,1cadaf34,Rotational Player
1244,Federico Di Francesco,5,2021-2022,27,it ITA,Empoli,it Serie A,26,1367,15.2,17,9,4,5,0,5,5,0,0,0,FWMF,1fca9171,Rotational Player
1245,Willi Orban,5,2024-2025,31,hu HUN,RB Leipzig,de Bundesliga,17,1524,16.9,17,0,0,5,0,5,5,0,0,0,DF,20030c06,Full Starter
1246,Jonas Wind,5,2021-2022,22,dk DEN,Wolfsburg,de Bundesliga,14,1180,13.1,14,0,0,5,1,6,5,0,0,0,FWMF,2077ae86,Rotational Player
1247,Lazar Samardzic,5,2022-2023,20,rs SRB,Udinese,it Serie A,37,1848,20.5,19,18,1,5,4,9,5,0,0,0,MF,217c93a1,Rotational Player
1248,Ignatius Ganago,5,2022-2023,23,cm CMR,2 Teams,fr Ligue 1,32,1579,17.5,16,16,1,5,3,8,5,0,0,0,FWMF,23c63b7f,Rotational Player
1249,Ignatius Ganago,5,2021-2022,22,cm CMR,Lens,fr Ligue 1,28,1024,11.4,11,17,3,5,1,6,5,0,0,0,FW,23c63b7f,Rotational Player
1250,Boulaye Dia,5,2021-2022,24,sn SEN,Villarreal,es La Liga,25,1269,14.1,13,12,4,5,5,10,5,0,0,0,FW,244bc2c8,Rotational Player
1251,Manuel Lanzini,5,2021-2022,28,ar ARG,West Ham,eng Premier League,30,1786,19.8,19,11,6,5,3,8,2,3,3,0,MFFW,26f6dca8,Rotational Player
1252,Éder Militão,5,2022-2023,24,br BRA,Real Madrid,es La Liga,33,2703,30.0,30,3,2,5,0,5,5,0,0,0,DF,2784f898,Full Starter
1253,Xavier Chavalerin,5,2021-2022,30,fr FRA,2 Teams,fr Ligue 1,37,2937,32.6,33,4,0,5,2,7,5,0,0,0,MF,279ddf6a,Full Starter
1254,Lewis Dunk,5,2020-2021,28,eng ENG,Brighton,eng Premier League,33,2931,32.6,33,0,0,5,0,5,5,0,0,0,DF,282f75f3,Full Starter
1255,Jonas Hofmann,5,2023-2024,31,de GER,Leverkusen,de Bundesliga,32,2204,24.5,26,6,1,5,7,12,5,0,0,0,MF,2903a856,Full Starter
1256,Gerrit Holtmann,5,2021-2022,26,ph PHI,Bochum,de Bundesliga,29,1840,20.4,23,6,0,5,4,9,5,0,0,0,FWMF,2979c05a,Rotational Player
1257,Benedict Hollerbach,5,2023-2024,22,de GER,Union Berlin,de Bundesliga,28,1282,14.2,15,13,5,5,0,5,5,0,0,0,FWMF,2a158218,Rotational Player
1258,Marshall Munetsi,5,2021-2022,25,zw ZIM,Reims,fr Ligue 1,24,1885,20.9,20,4,0,5,1,6,5,0,0,0,MFDF,2acf0cd7,Rotational Player
1259,Leroy Sané,5,2024-2025,28,de GER,Bayern Munich,de Bundesliga,15,831,9.2,9,6,2,5,2,7,5,0,0,0,FW,2b114be3,Rotational Player
1260,Allan Saint-Maximin,5,2021-2022,24,fr FRA,Newcastle Utd,eng Premier League,35,2804,31.2,31,4,0,5,5,10,5,0,0,0,FWMF,2b16cb1a,Rotational Player
1261,Florian Thauvin,5,2023-2024,30,fr FRA,Udinese,it Serie A,29,1710,19.0,19,10,3,5,3,8,4,1,1,0,FW,2b9fdeea,Rotational Player
1262,Florian Thauvin,5,2024-2025,31,fr FRA,Udinese,it Serie A,19,1435,15.9,18,1,0,5,3,8,5,0,2,2,FWMF,2b9fdeea,Rotational Player
1263,Eric García,5,2023-2024,22,es ESP,2 Teams,es La Liga,32,2694,29.9,30,2,2,5,0,5,5,0,0,0,DF,2bed3eab,Full Starter
1264,Jamal Musiala,5,2021-2022,18,de GER,Bayern Munich,de Bundesliga,30,1465,16.3,12,18,2,5,5,10,5,0,0,0,MFFW,2c0558b8,Rotational Player
1265,Alexis Sánchez,5,2021-2022,32,cl CHI,Inter,it Serie A,27,881,9.8,7,20,6,5,2,7,5,0,0,0,FW,2c0f8e9e,Rotational Player
1266,Armand Lauriente,5,2023-2024,24,fr FRA,Sassuolo,it Serie A,37,2908,32.3,35,2,0,5,4,9,5,0,0,0,FW,2d22cea7,Full Starter
1267,Emmanuel Sabbi,5,2023-2024,25,us USA,Le Havre,fr Ligue 1,30,1584,17.6,18,12,2,5,1,6,3,2,2,0,FWMF,2e1b7c83,Rotational Player
1268,Zeki Amdouni,5,2023-2024,22,ch SUI,Burnley,eng Premier League,34,1953,21.7,27,7,4,5,1,6,4,1,1,0,FW,2ee5b0c9,Full Starter
1269,Charles De Ketelaere,5,2024-2025,23,be BEL,Atalanta,it Serie A,21,1369,15.2,17,4,0,5,5,10,5,0,0,0,MFFW,2ef7c612,Rotational Player
1270,Tijjani Noslin,5,2023-2024,24,nl NED,Hellas Verona,it Serie A,17,1339,14.9,17,0,0,5,4,9,5,0,0,0,FWMF,2f067cf2,Rotational Player
1271,Aarón Martín,5,2022-2023,25,es ESP,Mainz 05,de Bundesliga,28,1847,20.5,20,8,6,5,3,8,5,0,1,1,DF,2f3e911a,Rotational Player
1272,Anthony Elanga,5,2023-2024,21,se SWE,Nott'ham Forest,eng Premier League,36,2433,27.0,25,11,0,5,9,14,5,0,0,0,FWMF,2fba6108,Rotational Player
1273,Philipp Lienhart,5,2021-2022,25,at AUT,Freiburg,de Bundesliga,32,2870,31.9,32,0,0,5,0,5,5,0,0,0,DF,302527b2,Full Starter
1274,Kevin Behrens,5,2023-2024,32,de GER,2 Teams,de Bundesliga,31,1878,20.9,21,10,2,5,1,6,5,0,0,0,FW,30ae134d,Rotational Player
1275,Morgan Gibbs-White,5,2022-2023,22,eng ENG,2 Teams,eng Premier League,37,3151,35.0,36,1,0,5,8,13,3,2,2,0,FWMF,32f60ed8,Full Starter
1276,Morgan Gibbs-White,5,2023-2024,23,eng ENG,Nott'ham Forest,eng Premier League,37,3156,35.1,35,2,0,5,10,15,4,1,1,0,MFFW,32f60ed8,Full Starter
1277,Phillip Tietz,5,2024-2025,27,de GER,Augsburg,de Bundesliga,19,1075,11.9,13,6,0,5,1,6,4,1,1,0,FW,3397e7b5,Rotational Player
1278,Lee Jae-sung,5,2024-2025,31,kr KOR,Mainz 05,de Bundesliga,18,1510,16.8,18,0,0,5,2,7,5,0,0,0,MF,34b0387f,Rotational Player
1279,Antonio Candreva,5,2020-2021,33,it ITA,Sampdoria,it Serie A,35,2505,27.8,28,7,0,5,8,13,3,2,2,0,MF,356c9002,Full Starter
1280,Fares Chaïbi,5,2022-2023,19,dz ALG,Toulouse,fr Ligue 1,36,2340,26.0,24,12,0,5,5,10,5,0,0,0,FWMF,357103bd,Rotational Player
1281,Léo Baptistão,5,2022-2023,29,br BRA,Almería,es La Liga,28,1726,19.2,24,4,1,5,1,6,5,0,0,0,FWMF,35f6db55,Rotational Player
1282,Aleksandr Golovin,5,2020-2021,24,ru RUS,Monaco,fr Ligue 1,21,1069,11.9,12,9,0,5,9,14,5,0,0,0,MFFW,3708e9fa,Rotational Player
1283,Jesper Lindstrøm,5,2021-2022,21,dk DEN,Eint Frankfurt,de Bundesliga,29,1976,22.0,26,3,2,5,4,9,5,0,0,0,MFFW,37dc1a48,Rotational Player
1284,Leandro Trossard,5,2020-2021,25,be BEL,Brighton,eng Premier League,35,2607,29.0,30,5,1,5,5,10,5,0,0,0,MFFW,38ceb24a,Rotational Player
1285,Ross Barkley,5,2023-2024,29,eng ENG,Luton Town,eng Premier League,32,2618,29.1,30,2,0,5,4,9,5,0,0,0,MF,3a24769f,Rotational Player
1286,Gianluca Gaetano,5,2023-2024,23,it ITA,2 Teams,it Serie A,20,906,10.1,11,9,13,5,1,6,4,1,1,0,FWMF,3b387cc7,Rotational Player
1287,Rodrigo Bentancur,5,2022-2023,25,uy URU,Tottenham,eng Premier League,18,1500,16.7,17,1,0,5,2,7,5,0,0,0,MF,3b8674e6,Rotational Player
1288,Eliesse Ben Seghir,5,2024-2025,19,ma MAR,Monaco,fr Ligue 1,19,1222,13.6,14,5,0,5,3,8,3,2,2,0,MFFW,3bd65247,Rotational Player
1289,Thomas Müller,5,2023-2024,33,de GER,Bayern Munich,de Bundesliga,31,1654,18.4,20,11,3,5,9,14,5,0,0,0,MFFW,3c6089ab,Full Starter
1290,Pedro,5,2020-2021,33,es ESP,Roma,it Serie A,27,1591,17.7,20,7,1,5,2,7,5,0,0,0,MFFW,3ca7254a,Rotational Player
1291,Moise Kean,5,2021-2022,21,it ITA,2 Teams,2 Comps,33,1099,12.2,12,21,0,5,2,7,5,0,0,0,FW,3d50bcdb,Rotational Player
1292,Harvey Barnes,5,2023-2024,25,eng ENG,Newcastle Utd,eng Premier League,21,802,8.9,7,14,0,5,3,8,5,0,0,0,FWMF,3ea50f67,Rotational Player
1293,Harvey Barnes,5,2024-2025,26,eng ENG,Newcastle Utd,eng Premier League,20,782,8.7,6,14,0,5,1,6,5,0,0,0,FW,3ea50f67,Rotational Player
1294,Lucas Martínez Quarta,5,2023-2024,27,ar ARG,Fiorentina,it Serie A,29,2291,25.5,26,3,5,5,1,6,5,0,0,0,DF,3ec3c1c9,Full Starter
1295,Gonzalo Escalante,5,2021-2022,28,ar ARG,2 Teams,2 Comps,18,1309,14.5,15,3,15,5,0,5,5,0,0,0,MF,3f79a1c8,Rotational Player
1296,Milan Đurić,5,2021-2022,31,ba BIH,Salernitana,it Serie A,33,2165,24.1,23,10,0,5,4,9,4,1,1,0,FW,405f6586,Rotational Player
1297,Rafael Ratão,5,2022-2023,26,br BRA,Toulouse,fr Ligue 1,30,1851,20.6,25,5,1,5,4,9,5,0,0,0,FWMF,40ef7347,Rotational Player
1298,Jhon Durán,5,2023-2024,19,co COL,Aston Villa,eng Premier League,23,475,5.3,3,20,5,5,0,5,5,0,0,0,FWMF,414184f7,Bench Player
1299,Frank Magri,5,2023-2024,23,cm CMR,Toulouse,fr Ligue 1,29,1438,16.0,14,15,0,5,2,7,5,0,0,0,FWMF,42fdb11d,Rotational Player
1300,Joshua King,5,2021-2022,29,no NOR,Watford,eng Premier League,32,2248,25.0,27,5,1,5,3,8,4,1,1,0,FW,43458538,Rotational Player
1301,Christoph Baumgartner,5,2023-2024,23,at AUT,RB Leipzig,de Bundesliga,32,1158,12.9,11,21,2,5,1,6,5,0,0,0,MFFW,437f2b00,Rotational Player
1302,Ridle Baku,5,2022-2023,24,de GER,Wolfsburg,de Bundesliga,33,2580,28.7,29,4,0,5,3,8,5,0,0,0,DFFW,442b56fa,Full Starter
1303,Oumar Diakité,5,2023-2024,19,ci CIV,Reims,fr Ligue 1,28,1585,17.6,18,10,2,5,1,6,5,0,1,1,FW,44435c8f,Rotational Player
1304,Demarai Gray,5,2021-2022,25,jm JAM,Everton,eng Premier League,34,2338,26.0,28,6,0,5,4,9,5,0,0,0,MFFW,4468ec10,Full Starter
1305,Rúben Neves,5,2020-2021,23,pt POR,Wolves,eng Premier League,36,2675,29.7,31,5,1,5,1,6,2,3,3,0,MF,44bfb6c5,Full Starter
1306,Chris Ramos,5,2023-2024,26,es ESP,Cádiz,es La Liga,37,2612,29.0,30,7,0,5,1,6,5,0,0,0,FWMF,44e07fac,Full Starter
1307,Nicolas Viola,5,2020-2021,30,it ITA,Benevento,it Serie A,17,1036,11.5,12,5,10,5,2,7,1,4,4,0,MF,45392b06,Rotational Player
1308,Nicolas Viola,5,2023-2024,33,it ITA,Cagliari,it Serie A,26,1207,13.4,11,15,10,5,2,7,5,0,1,1,MFFW,45392b06,Rotational Player
1309,Marco Asensio,5,2020-2021,24,es ESP,Real Madrid,es La Liga,35,1869,20.8,21,14,1,5,2,7,5,0,0,0,FWMF,45af8a54,Rotational Player
1310,Denzel Dumfries,5,2021-2022,25,nl NED,Inter,it Serie A,33,2028,22.5,21,12,5,5,4,9,5,0,0,0,DF,481c9ece,Rotational Player
1311,Joshua Kimmich,5,2022-2023,27,de GER,Bayern Munich,de Bundesliga,33,2809,31.2,32,1,0,5,6,11,4,1,1,0,MF,49296448,Full Starter
1312,Angelo Fulgini,5,2021-2022,24,fr FRA,Angers,fr Ligue 1,36,2929,32.5,35,1,0,5,4,9,5,0,0,0,MFFW,4b96c347,Full Starter
1313,Lois Diony,5,2020-2021,27,fr FRA,Angers,fr Ligue 1,36,1749,19.4,20,16,0,5,1,6,4,1,1,0,FW,4be0b467,Rotational Player
1314,Maxi Gómez,5,2021-2022,24,uy URU,Valencia,es La Liga,29,1956,21.7,21,8,0,5,1,6,5,0,0,0,FW,4c2e9442,Full Starter
1315,Roberto Firmino,5,2021-2022,29,br BRA,Liverpool,eng Premier League,20,990,11.0,10,10,2,5,4,9,5,0,0,0,FW,4c370d81,Rotational Player
1316,Chris Wood,5,2021-2022,29,nz NZL,2 Teams,eng Premier League,34,2694,29.9,32,2,1,5,0,5,4,1,1,0,FW,4e9a0555,Rotational Player
1317,Bruno Fernandes,5,2024-2025,29,pt POR,Manchester Utd,eng Premier League,22,1835,20.4,22,0,0,5,6,11,2,3,3,0,MF,507c7bdf,Full Starter
1318,Yangel Herrera,5,2023-2024,25,ve VEN,Girona,es La Liga,29,2107,23.4,27,2,1,5,0,5,5,0,0,0,MF,5083a734,Full Starter
1319,Jean-Philippe Mateta,5,2021-2022,24,fr FRA,Crystal Palace,eng Premier League,22,1145,12.7,13,9,8,5,1,6,5,0,0,0,FW,50e6dc35,Rotational Player
1320,Alex Baena,5,2024-2025,23,es ESP,Villarreal,es La Liga,19,1550,17.2,18,1,0,5,5,10,5,0,1,1,MFFW,518f2234,Rotational Player
1321,Jonathan Clauss,5,2021-2022,28,fr FRA,Lens,fr Ligue 1,37,3046,33.8,35,2,0,5,11,16,5,0,0,0,DF,5219ab4a,Full Starter
1322,Lucas Torreira,5,2021-2022,25,uy URU,Fiorentina,it Serie A,31,2195,24.4,26,5,3,5,1,6,5,0,0,0,MF,52611641,Full Starter
1323,Edinson Cavani,5,2022-2023,35,uy URU,Valencia,es La Liga,25,1449,16.1,20,5,1,5,2,7,3,2,3,1,FW,527f063d,Rotational Player
1324,Luis Alberto,5,2023-2024,30,es ESP,Lazio,it Serie A,33,2311,25.7,29,4,1,5,7,12,5,0,0,0,MF,5294a83f,Full Starter
1325,Luis Alberto,5,2021-2022,28,es ESP,Lazio,it Serie A,34,2353,26.1,27,7,1,5,9,14,5,0,0,0,MF,5294a83f,Full Starter
1326,Leonardo Bonucci,5,2021-2022,34,it ITA,Juventus,it Serie A,24,2005,22.3,22,2,6,5,0,5,2,3,3,0,DF,52ec54d0,Rotational Player
1327,Pau Torres,5,2021-2022,24,es ESP,Villarreal,es La Liga,33,2855,31.7,33,0,1,5,1,6,5,0,0,0,DF,532e1e4f,Full Starter
1328,Vincenzo Grifo,5,2024-2025,31,it ITA,Freiburg,de Bundesliga,19,1333,14.8,17,2,0,5,7,12,5,0,2,2,FWMF,54e4866f,Full Starter
1329,Gianluca Caprari,5,2022-2023,29,it ITA,Monza,it Serie A,37,2441,27.1,32,5,0,5,2,7,4,1,1,0,MFFW,54e53b7e,Full Starter
1330,Gianluca Caprari,5,2020-2021,27,it ITA,Benevento,it Serie A,30,1865,20.7,23,7,2,5,6,11,5,0,1,1,MFFW,54e53b7e,Full Starter
1331,Adam Hložek,5,2022-2023,20,cz CZE,Leverkusen,de Bundesliga,29,1286,14.3,16,13,3,5,3,8,5,0,0,0,FWMF,5521f419,Rotational Player
1332,Hamed Junior Traorè,5,2020-2021,20,ci CIV,Sassuolo,it Serie A,35,1789,19.9,20,15,2,5,2,7,5,0,0,0,MFFW,570bb4b9,Rotational Player
1333,Mauro Arambarri,5,2024-2025,28,uy URU,Getafe,es La Liga,19,1281,14.2,15,4,0,5,0,5,3,2,2,0,MF,58afe001,Rotational Player
1334,Mason Greenwood,5,2021-2022,19,eng ENG,Manchester Utd,eng Premier League,18,1271,14.1,16,2,3,5,1,6,5,0,0,0,FWMF,58eee997,Rotational Player
1335,Dominic Calvert-Lewin,5,2021-2022,24,eng ENG,Everton,eng Premier League,17,1283,14.3,15,2,3,5,2,7,3,2,3,1,FW,59e6e5bf,Rotational Player
1336,Joško Gvardiol,5,2024-2025,22,hr CRO,Manchester City,eng Premier League,22,1932,21.5,21,1,1,5,0,5,5,0,0,0,DF,5ad50391,Rotational Player
1337,Myron Boadu,5,2024-2025,23,nl NED,Bochum,de Bundesliga,9,517,5.7,6,3,3,5,1,6,4,1,1,0,FW,5b479568,Bench Player
1338,Marcus Tavernier,5,2022-2023,23,eng ENG,Bournemouth,eng Premier League,23,1743,19.4,19,4,0,5,4,9,5,0,0,0,MFFW,5c0da4a4,Rotational Player
1339,André Ayew,5,2023-2024,33,gh GHA,Le Havre,fr Ligue 1,19,1104,12.3,12,7,0,5,0,5,5,0,0,0,FW,5dbefa9d,Rotational Player
1340,Iliman Ndiaye,5,2024-2025,24,sn SEN,Everton,eng Premier League,22,1763,19.6,20,2,0,5,0,5,4,1,1,0,FW,5ed97752,Rotational Player
1341,Moses Simon,5,2024-2025,29,ng NGA,Nantes,fr Ligue 1,17,1430,15.9,17,0,0,5,6,11,3,2,2,0,FWMF,5f3eaaf5,Rotational Player
1342,Moses Simon,5,2022-2023,27,ng NGA,Nantes,fr Ligue 1,34,2346,26.1,28,6,0,5,4,9,4,1,1,0,FWMF,5f3eaaf5,Rotational Player
1343,Gleison Bremer,5,2020-2021,23,br BRA,Torino,it Serie A,33,2935,32.6,33,0,4,5,0,5,5,0,0,0,DF,5fd5ed86,Full Starter
1344,Luka Modrić,5,2020-2021,34,hr CRO,Real Madrid,es La Liga,35,2733,30.4,32,3,1,5,3,8,5,0,0,0,MF,6025fab1,Full Starter
1345,Jeong Woo-yeong,5,2021-2022,21,kr KOR,Freiburg,de Bundesliga,32,1782,19.8,23,9,0,5,2,7,5,0,0,0,FWMF,6190474d,Rotational Player
1346,Ludovic Blas,5,2024-2025,26,fr FRA,Rennes,fr Ligue 1,19,1562,17.4,18,1,0,5,6,11,5,0,0,0,MFFW,6191093d,Full Starter
1347,Tomáš Souček,5,2024-2025,29,cz CZE,West Ham,eng Premier League,21,1615,17.9,18,3,0,5,1,6,5,0,0,0,MF,6613c819,Full Starter
1348,Tomáš Souček,5,2021-2022,26,cz CZE,West Ham,eng Premier League,35,3062,34.0,34,1,1,5,1,6,5,0,0,0,MF,6613c819,Full Starter
1349,Emi Buendía,5,2022-2023,25,ar ARG,Aston Villa,eng Premier League,38,2412,26.8,27,11,0,5,2,7,5,0,0,0,MFFW,66b76d44,Rotational Player
1350,Gabriel Magalhães,5,2021-2022,23,br BRA,Arsenal,eng Premier League,35,3063,34.0,35,0,0,5,0,5,5,0,0,0,DF,67ac5bb8,Full Starter
1351,Jonathan Calleri,5,2020-2021,26,ar ARG,Osasuna,es La Liga,25,1544,17.2,20,5,2,5,2,7,5,0,0,0,FW,6922f806,Rotational Player
1352,Gorka Guruzeta,5,2024-2025,27,es ESP,Athletic Club,es La Liga,20,1076,12.0,12,8,0,5,2,7,5,0,0,0,FW,6b5ea2f4,Rotational Player
1353,Andre-Frank Zambo Anguissa,5,2024-2025,28,cm CMR,Napoli,it Serie A,22,1949,21.7,22,0,0,5,3,8,5,0,0,0,MF,6bb2c084,Full Starter
1354,Téji Savanier,5,2020-2021,28,fr FRA,Montpellier,fr Ligue 1,27,2165,24.1,26,1,0,5,5,10,3,2,4,2,MF,6bde367b,Full Starter
1355,Alex Iwobi,5,2023-2024,27,ng NGA,2 Teams,eng Premier League,32,2332,25.9,27,5,0,5,2,7,5,0,0,0,MF,6ca5ec4b,Rotational Player
1356,Youssoufa Moukoko,5,2023-2024,18,de GER,Dortmund,de Bundesliga,20,625,6.9,4,16,10,5,0,5,5,0,0,0,FW,6ce43701,Bench Player
1357,Giacomo Raspadori,5,2023-2024,23,it ITA,Napoli,it Serie A,37,1584,17.6,14,23,0,5,3,8,5,0,1,1,FWMF,6e058f06,Rotational Player
1358,Papu Gómez,5,2021-2022,33,ar ARG,Sevilla,es La Liga,29,1784,19.8,19,10,1,5,1,6,5,0,0,0,FWMF,6e4df551,Rotational Player
1359,Evanilson,5,2024-2025,24,br BRA,Bournemouth,eng Premier League,19,1370,15.2,17,2,0,5,0,5,5,0,1,1,FW,6f3cc2fe,Rotational Player
1360,Enzo Le Fée,5,2022-2023,22,fr FRA,Lorient,fr Ligue 1,35,3028,33.6,35,0,0,5,6,11,5,0,0,0,MF,6f806d99,Full Starter
1361,Janik Haberer,5,2022-2023,28,de GER,Union Berlin,de Bundesliga,32,2187,24.3,30,2,0,5,1,6,5,0,0,0,MF,70dcf94d,Rotational Player
1362,Cucho,5,2021-2022,22,co COL,Watford,eng Premier League,25,1147,12.7,11,14,7,5,2,7,5,0,0,0,FWMF,71b47ab9,Rotational Player
1363,Lucas Tousart,5,2022-2023,25,fr FRA,Hertha BSC,de Bundesliga,33,2944,32.7,33,0,0,5,2,7,5,0,0,0,MF,71ec39ef,Full Starter
1364,Cristian Tello,5,2020-2021,28,es ESP,Betis,es La Liga,29,1283,14.3,12,17,5,5,3,8,5,0,0,0,FWMF,72a99e38,Rotational Player
1365,Alexis Claude-Maurice,5,2022-2023,24,fr FRA,2 Teams,fr Ligue 1,22,668,7.4,6,16,8,5,3,8,5,0,0,0,FW,741418c3,Rotational Player
1366,Romain Faivre,5,2023-2024,25,fr FRA,2 Teams,2 Comps,22,1494,16.6,16,6,8,5,1,6,5,0,0,0,MFFW,745ca0a3,Rotational Player
1367,Romain Faivre,5,2022-2023,24,fr FRA,2 Teams,fr Ligue 1,26,1546,17.2,17,9,5,5,4,9,5,0,0,0,MFFW,745ca0a3,Rotational Player
1368,Kaoru Mitoma,5,2024-2025,27,jp JPN,Brighton,eng Premier League,23,1845,20.5,20,3,0,5,3,8,5,0,0,0,FWMF,74618572,Rotational Player
1369,Vitinha,5,2023-2024,23,pt POR,2 Teams,2 Comps,27,1208,13.4,12,15,2,5,2,7,5,0,0,0,FW,74d4cec6,Rotational Player
1370,Borja Iglesias,5,2024-2025,31,es ESP,Celta Vigo,es La Liga,20,1078,12.0,13,7,0,5,0,5,5,0,0,0,FW,75645f0e,Rotational Player
1371,Salva Sevilla,5,2021-2022,37,es ESP,Mallorca,es La Liga,28,1507,16.7,17,11,6,5,3,8,1,4,4,0,MF,75bd85ea,Rotational Player
1372,Roberto Pereyra,5,2020-2021,29,ar ARG,Udinese,it Serie A,34,2925,32.5,34,0,0,5,7,12,4,1,1,0,MFFW,75f2c59f,Full Starter
1373,Roberto Pereyra,5,2022-2023,31,ar ARG,Udinese,it Serie A,34,2820,31.3,33,1,2,5,7,12,5,0,1,1,DFMF,75f2c59f,Full Starter
1374,Rey Manaj,5,2021-2022,24,al ALB,2 Teams,2 Comps,30,1768,19.6,19,11,6,5,0,5,3,2,3,1,FW,7703afb6,Rotational Player
1375,Matteo Pessina,5,2022-2023,25,it ITA,Monza,it Serie A,35,2932,32.6,34,1,1,5,3,8,2,3,3,0,MF,780e3631,Full Starter
1376,Morgan Guilavogui,5,2024-2025,26,gn GUI,St. Pauli,de Bundesliga,17,1248,13.9,15,2,0,5,1,6,5,0,0,0,FWMF,79b51257,Rotational Player
1377,Jarrod Bowen,5,2024-2025,27,eng ENG,West Ham,eng Premier League,19,1655,18.4,19,0,0,5,4,9,4,1,1,0,FWMF,79c84d1c,Full Starter
1378,Arnaud Nordin,5,2023-2024,25,fr FRA,Montpellier,fr Ligue 1,20,1246,13.8,15,5,0,5,3,8,5,0,0,0,FWMF,7b9a9e25,Rotational Player
1379,Pedro Neto,5,2020-2021,20,pt POR,Wolves,eng Premier League,31,2550,28.3,30,1,0,5,6,11,5,0,0,0,FWMF,7ba2eaa9,Full Starter
1380,Óscar Plano,5,2020-2021,29,es ESP,Valladolid,es La Liga,36,2517,28.0,30,6,0,5,5,10,5,0,0,0,MFFW,7c388b20,Full Starter
1381,Destiny Udogie,5,2021-2022,18,it ITA,Udinese,it Serie A,35,2477,27.5,29,6,1,5,3,8,5,0,0,0,DF,7cd520e8,Full Starter
1382,Gaëtan Laborde,5,2023-2024,29,fr FRA,Nice,fr Ligue 1,34,1906,21.2,22,12,0,5,2,7,4,1,2,1,FWMF,7cdda3bf,Full Starter
1383,Fabinho,5,2021-2022,27,br BRA,Liverpool,eng Premier League,29,2314,25.7,26,3,1,5,1,6,3,2,2,0,MF,7f3b388c,Full Starter
1384,İlkay Gündoğan,5,2023-2024,32,de GER,Barcelona,es La Liga,36,2994,33.3,33,3,1,5,9,14,4,1,2,1,MF,819b3158,Full Starter
1385,Samuel Essende,5,2024-2025,26,cd COD,Augsburg,de Bundesliga,17,994,11.0,12,5,0,5,2,7,5,0,0,0,FW,821550ce,Rotational Player
1386,Bruno Guimarães,5,2021-2022,23,br BRA,2 Teams,2 Comps,37,2668,29.6,30,7,0,5,4,9,5,0,0,0,MF,82518f62,Full Starter
1387,Nadir Zortea,5,2024-2025,25,it ITA,Cagliari,it Serie A,19,1389,15.4,17,2,1,5,0,5,5,0,0,0,DFFW,82598b71,Rotational Player
1388,Pablo Fornals,5,2020-2021,24,es ESP,West Ham,eng Premier League,33,2572,28.6,31,2,3,5,4,9,5,0,0,0,FWMF,82927de4,Rotational Player
1389,Mathys Tel,5,2022-2023,17,fr FRA,Bayern Munich,de Bundesliga,22,417,4.6,1,21,9,5,0,5,5,0,0,0,FW,829aa60c,Bench Player
1390,Lamine Yamal,5,2024-2025,17,es ESP,Barcelona,es La Liga,18,1434,15.9,16,2,0,5,10,15,5,0,0,0,FW,82ec26c1,Rotational Player
1391,Lamine Yamal,5,2023-2024,16,es ESP,Barcelona,es La Liga,37,2201,24.5,22,15,1,5,5,10,5,0,0,0,FW,82ec26c1,Rotational Player
1392,Sandro Ramírez,5,2020-2021,25,es ESP,Huesca,es La Liga,20,1285,14.3,16,4,3,5,1,6,5,0,0,0,FW,833fb62e,Rotational Player
1393,Alexis Mac Allister,5,2021-2022,22,ar ARG,Brighton,eng Premier League,33,2123,23.6,22,11,5,5,2,7,3,2,3,1,MFFW,83d074ff,Full Starter
1394,Alexis Mac Allister,5,2023-2024,24,ar ARG,Liverpool,eng Premier League,33,2599,28.9,31,2,0,5,5,10,4,1,1,0,MF,83d074ff,Full Starter
1395,Esteban Lepaul,5,2024-2025,24,fr FRA,Angers,fr Ligue 1,15,551,6.1,5,10,4,5,0,5,5,0,0,0,FW,85ce1949,Bench Player
1396,Simon Terodde,5,2022-2023,34,de GER,Schalke 04,de Bundesliga,32,1823,20.3,21,11,1,5,0,5,5,0,1,1,FW,863ff1ee,Rotational Player
1397,Maximilian Arnold,5,2022-2023,28,de GER,Wolfsburg,de Bundesliga,32,2767,30.7,32,0,0,5,3,8,2,3,5,2,MF,86e119e0,Full Starter
1398,Adrien Rabiot,5,2023-2024,28,fr FRA,Juventus,it Serie A,31,2651,29.5,30,1,0,5,3,8,5,0,0,0,MF,8794e251,Full Starter
1399,Jérémy Le Douaron,5,2021-2022,23,fr FRA,Brest,fr Ligue 1,32,1446,16.1,16,16,1,5,3,8,5,0,0,0,FWMF,88c4d190,Rotational Player
1400,Riyad Mahrez,5,2022-2023,31,dz ALG,Manchester City,eng Premier League,30,1920,21.3,22,8,8,5,10,15,4,1,1,0,FWMF,892d5bb1,Rotational Player
1401,Ike Ugbo,5,2021-2022,22,ca CAN,Troyes,fr Ligue 1,14,814,9.0,11,3,1,5,0,5,4,1,1,0,FW,8a53d24b,Rotational Player
1402,Carlos Vinícius,5,2022-2023,27,br BRA,Fulham,eng Premier League,28,1109,12.3,11,17,5,5,2,7,5,0,0,0,FW,8b529245,Rotational Player
1403,Willian,5,2022-2023,33,br BRA,Fulham,eng Premier League,27,2126,23.6,25,2,0,5,5,10,5,0,0,0,FW,8b9ebd03,Rotational Player
1404,Marco Grüll,5,2024-2025,26,at AUT,Werder Bremen,de Bundesliga,17,817,9.1,10,7,0,5,1,6,5,0,0,0,FWMF,8babb812,Rotational Player
1405,Ángel Rodríguez,5,2020-2021,33,es ESP,Getafe,es La Liga,33,1374,15.3,12,21,4,5,0,5,4,1,2,1,FWMF,8cfc2f69,Rotational Player
1406,Rodrigo Palacio,5,2020-2021,38,ar ARG,Bologna,it Serie A,36,2502,27.8,28,8,1,5,5,10,5,0,0,0,FW,8d8178ac,Full Starter
1407,Luis Sinisterra,5,2022-2023,23,co COL,Leeds United,eng Premier League,19,867,9.6,13,6,1,5,0,5,5,0,0,0,FW,8e16dd48,Rotational Player
1408,Timothy Weah,5,2024-2025,24,us USA,Juventus,it Serie A,14,749,8.3,8,6,2,5,1,6,5,0,0,0,FW,8eec784d,Rotational Player
1409,Memphis,5,2022-2023,28,nl NED,2 Teams,es La Liga,10,384,4.3,5,5,8,5,0,5,5,0,0,0,FW,8f696594,Rotational Player
1410,Memphis,5,2023-2024,29,nl NED,Atlético Madrid,es La Liga,23,893,9.9,9,14,3,5,1,6,5,0,0,0,FW,8f696594,Rotational Player
1411,Danilo Pereira,5,2021-2022,29,pt POR,Paris S-G,fr Ligue 1,27,2038,22.6,22,5,9,5,0,5,5,0,0,0,MF,8fd9996f,Rotational Player
1412,Nuno da Costa,5,2022-2023,31,cv CPV,Auxerre,fr Ligue 1,33,2003,22.3,23,10,0,5,4,9,5,0,0,0,FWMF,909222de,Rotational Player
1413,Álvaro García,5,2022-2023,29,es ESP,Rayo Vallecano,es La Liga,35,2870,31.9,34,1,0,5,5,10,5,0,0,0,FWMF,90bbd822,Full Starter
1414,Wesley Saïd,5,2021-2022,26,fr FRA,Lens,fr Ligue 1,21,654,7.3,7,14,3,5,0,5,5,0,0,0,FWMF,90fcf472,Bench Player
1415,Wesley Saïd,5,2022-2023,27,fr FRA,Lens,fr Ligue 1,21,644,7.2,6,15,1,5,0,5,5,0,0,0,FWMF,90fcf472,Bench Player
1416,Mattias Svanberg,5,2020-2021,21,se SWE,Bologna,it Serie A,34,1852,20.6,24,10,1,5,2,7,5,0,0,0,MF,92d83c27,Full Starter
1417,Florian Kainz,5,2023-2024,30,at AUT,Köln,de Bundesliga,33,2197,24.4,29,4,1,5,4,9,0,5,5,0,MFFW,94c18565,Full Starter
1418,Junior Dina Ebimbe,5,2023-2024,22,fr FRA,Eint Frankfurt,de Bundesliga,31,1956,21.7,25,6,0,5,3,8,5,0,0,0,MFDF,95bb6ddc,Rotational Player
1419,Sandi Lovrić,5,2022-2023,24,si SVN,Udinese,it Serie A,37,2335,25.9,28,9,0,5,6,11,5,0,0,0,MF,966eea58,Full Starter
1420,Federico Dimarco,5,2020-2021,22,it ITA,Hellas Verona,it Serie A,35,2613,29.0,29,6,2,5,3,8,5,0,0,0,DF,970b8574,Full Starter
1421,Federico Dimarco,5,2023-2024,25,it ITA,Inter,it Serie A,30,2077,23.1,29,1,6,5,6,11,5,0,0,0,DF,970b8574,Full Starter
1422,Kalifa Coulibaly,5,2021-2022,29,ml MLI,Nantes,fr Ligue 1,21,850,9.4,9,12,7,5,0,5,5,0,0,0,FW,9980269a,Rotational Player
1423,Branco van den Boomen,5,2022-2023,27,nl NED,Toulouse,fr Ligue 1,35,2888,32.1,32,3,0,5,8,13,1,4,4,0,MF,99d660b2,Full Starter
1424,Jefferson Lerma,5,2022-2023,27,co COL,Bournemouth,eng Premier League,37,3252,36.1,37,0,0,5,0,5,5,0,0,0,MF,9b5ce51a,Full Starter
1425,Alexandre Lacazette,5,2024-2025,33,fr FRA,Lyon,fr Ligue 1,17,1177,13.1,14,3,0,5,2,7,4,1,2,1,FW,9dbb75ca,Rotational Player
1426,Felipe Anderson,5,2023-2024,30,br BRA,Lazio,it Serie A,38,2770,30.8,33,5,0,5,6,11,5,0,0,0,FWMF,9f1893b9,Full Starter
1427,Lucas Ocampos,5,2020-2021,26,ar ARG,Sevilla,es La Liga,34,2631,29.2,30,4,0,5,4,9,1,4,5,1,FW,a08b974a,Rotational Player
1428,Bradley Barcola,5,2022-2023,19,fr FRA,Lyon,fr Ligue 1,26,1440,16.0,15,11,5,5,8,13,5,0,0,0,FWMF,a0d55a09,Rotational Player
1429,Flavien Tait,5,2021-2022,28,fr FRA,Rennes,fr Ligue 1,28,2125,23.6,24,4,1,5,3,8,5,0,0,0,MF,a0f9b535,Rotational Player
1430,Lucas Pérez,5,2021-2022,32,es ESP,3 Teams,es La Liga,33,2326,25.8,27,6,2,5,3,8,5,0,0,0,FW,a300ac7e,Rotational Player
1431,Cristian Romero,5,2023-2024,25,ar ARG,Tottenham,eng Premier League,33,2790,31.0,33,0,0,5,0,5,5,0,0,0,DF,a3d94a58,Full Starter
1432,Mark Uth,5,2021-2022,29,de GER,Köln,de Bundesliga,30,2025,22.5,24,6,0,5,8,13,5,0,0,0,MFFW,a3ddb1b9,Rotational Player
1433,M'Bala Nzola,5,2024-2025,27,ao ANG,Lens,fr Ligue 1,14,1035,11.5,12,2,1,5,1,6,5,0,0,0,FW,a4948e67,Rotational Player
1434,Eddie Nketiah,5,2021-2022,22,eng ENG,Arsenal,eng Premier League,21,835,9.3,8,13,5,5,1,6,5,0,0,0,FW,a53649b7,Bench Player
1435,Eddie Nketiah,5,2023-2024,24,eng ENG,Arsenal,eng Premier League,27,1082,12.0,10,17,11,5,2,7,5,0,0,0,FW,a53649b7,Bench Player
1436,Kevin Möhwald,5,2020-2021,27,de GER,Werder Bremen,de Bundesliga,27,1555,17.3,17,10,1,5,1,6,5,0,0,0,MF,a5ce09f2,Rotational Player
1437,Emre Can,5,2021-2022,27,de GER,Dortmund,de Bundesliga,24,1690,18.8,19,5,0,5,1,6,1,4,4,0,DFMF,a65ce836,Rotational Player
1438,Hirving Lozano,5,2021-2022,26,mx MEX,Napoli,it Serie A,30,1613,17.9,20,10,1,5,5,10,5,0,0,0,FW,a69e4806,Rotational Player
1439,Sergio Canales,5,2021-2022,30,es ESP,Betis,es La Liga,34,2791,31.0,33,1,0,5,8,13,5,0,0,0,FWMF,a6de370d,Full Starter
1440,Josh Sargent,5,2020-2021,20,us USA,Werder Bremen,de Bundesliga,32,2506,27.8,30,2,0,5,2,7,5,0,0,0,FWMF,a8d4428b,Full Starter
1441,Jack Harrison,5,2022-2023,25,eng ENG,Leeds United,eng Premier League,36,2708,30.1,34,2,1,5,7,12,5,0,0,0,FWMF,aa849a12,Full Starter
1442,Nikola Vlašić,5,2022-2023,24,hr CRO,2 Teams,2 Comps,34,2728,30.3,29,5,1,5,6,11,5,0,0,0,FWMF,aa8e289e,Full Starter
1443,Arne Maier,5,2022-2023,23,de GER,Augsburg,de Bundesliga,30,1960,21.8,24,6,3,5,1,6,5,0,0,0,MF,ab700320,Rotational Player
1444,Érik Lamela,5,2021-2022,29,ar ARG,Sevilla,es La Liga,20,1015,11.3,10,10,1,5,2,7,5,0,0,0,FWMF,abe66106,Rotational Player
1445,Michail Antonio,5,2022-2023,32,jm JAM,West Ham,eng Premier League,33,1829,20.3,21,12,1,5,3,8,5,0,0,0,FW,ac05f970,Rotational Player
1446,Dani Olmo,5,2020-2021,22,es ESP,RB Leipzig,de Bundesliga,32,2194,24.4,26,6,0,5,9,14,4,1,1,0,MF,ae44e8e2,Rotational Player
1447,Dani Olmo,5,2024-2025,26,es ESP,Barcelona,es La Liga,12,652,7.2,7,5,2,5,0,5,5,0,0,0,MFFW,ae44e8e2,Rotational Player
1448,Iván Martín,5,2023-2024,24,es ESP,Girona,es La Liga,36,2729,30.3,33,3,1,5,4,9,5,0,0,0,MF,ae48c5cb,Full Starter
1449,Édgar Méndez,5,2020-2021,30,es ESP,Alavés,es La Liga,33,2090,23.2,26,7,2,5,1,6,5,0,0,0,MFFW,aed746df,Full Starter
1450,Nico Williams,5,2023-2024,21,es ESP,Athletic Club,es La Liga,31,2263,25.1,29,2,0,5,11,16,5,0,0,0,FW,afdc14d7,Full Starter
1451,Nicolas de Préville,5,2021-2022,30,fr FRA,Metz,fr Ligue 1,27,1969,21.9,24,3,0,5,2,7,5,0,0,0,FWMF,b0547a87,Rotational Player
1452,Jack Grealish,5,2022-2023,26,eng ENG,Manchester City,eng Premier League,28,2055,22.8,23,5,5,5,7,12,5,0,0,0,FW,b0b4fd3e,Rotational Player
1453,Ousmane Dembélé,5,2022-2023,25,fr FRA,Barcelona,es La Liga,25,1410,15.7,16,9,0,5,7,12,5,0,0,0,FW,b19db005,Rotational Player
1454,Eli Junior Kroupi,5,2023-2024,17,fr FRA,Lorient,fr Ligue 1,30,1084,12.0,11,19,4,5,3,8,5,0,0,0,FWMF,b2fe86e5,Rotational Player
1455,Raúl García,5,2020-2021,34,es ESP,Athletic Club,es La Liga,34,1743,19.4,21,13,0,5,1,6,3,2,3,1,FWMF,b418dbd4,Rotational Player
1456,Tiago Tomás,5,2024-2025,22,pt POR,Wolfsburg,de Bundesliga,18,1218,13.5,15,3,0,5,1,6,5,0,0,0,FWMF,b492126a,Rotational Player
1457,Jordan Pefok,5,2023-2024,27,us USA,2 Teams,de Bundesliga,26,1447,16.1,18,8,2,5,3,8,5,0,0,0,FW,b684a484,Rotational Player
1458,Marvin Friedrich,5,2020-2021,24,de GER,Union Berlin,de Bundesliga,34,3060,34.0,34,0,0,5,2,7,5,0,0,0,DF,b77f44a4,Full Starter
1459,Josh Maja,5,2020-2021,21,ng NGA,2 Teams,2 Comps,32,1614,17.9,20,12,7,5,0,5,4,1,1,0,FW,bc0bfc64,Rotational Player
1460,Bukayo Saka,5,2024-2025,22,eng ENG,Arsenal,eng Premier League,16,1268,14.1,16,0,0,5,10,15,4,1,1,0,FWMF,bc7dc64d,Full Starter
1461,Bukayo Saka,5,2020-2021,18,eng ENG,Arsenal,eng Premier League,32,2553,28.4,30,2,4,5,3,8,5,0,0,0,FWMF,bc7dc64d,Full Starter
1462,Simon Banza,5,2020-2021,23,cd COD,Lens,fr Ligue 1,34,1372,15.2,12,22,3,5,2,7,4,1,1,0,FW,be47b750,Rotational Player
1463,Nabil Fekir,5,2020-2021,27,fr FRA,Betis,es La Liga,33,2622,29.1,33,0,0,5,6,11,4,1,3,2,MFFW,bece776f,Full Starter
1464,Darío Benedetto,5,2020-2021,30,ar ARG,Marseille,fr Ligue 1,32,1579,17.5,19,13,2,5,3,8,4,1,1,0,FW,bef0a7ac,Rotational Player
1465,Noni Madueke,5,2023-2024,21,eng ENG,Chelsea,eng Premier League,23,1053,11.7,13,10,10,5,2,7,4,1,1,0,FW,bf34eebd,Rotational Player
1466,Ismaila Sarr,5,2021-2022,23,sn SEN,Watford,eng Premier League,22,1861,20.7,21,1,0,5,2,7,5,0,1,1,FWMF,bfdb33aa,Rotational Player
1467,Iker Muniain,5,2020-2021,27,es ESP,Athletic Club,es La Liga,28,1943,21.6,23,5,1,5,3,8,5,0,0,0,MFFW,c05dfb74,Full Starter
1468,Wataru Endo,5,2022-2023,29,jp JPN,Stuttgart,de Bundesliga,33,2922,32.5,33,0,0,5,4,9,5,0,0,0,MF,c149016b,Full Starter
1469,Ellyes Skhiri,5,2020-2021,25,tn TUN,Köln,de Bundesliga,32,2785,30.9,32,0,1,5,2,7,5,0,0,0,MF,c2211709,Full Starter
1470,Conor Gallagher,5,2023-2024,23,eng ENG,Chelsea,eng Premier League,37,3128,34.8,37,0,0,5,7,12,5,0,0,0,MF,c2731c10,Full Starter
1471,Michael Folorunsho,5,2023-2024,25,it ITA,Hellas Verona,it Serie A,34,2781,30.9,33,1,0,5,1,6,5,0,0,0,MFFW,c391a179,Full Starter
1472,Dejan Ljubicic,5,2022-2023,24,at AUT,Köln,de Bundesliga,27,1710,19.0,20,7,0,5,1,6,4,1,1,0,MFFW,c455a2b2,Rotational Player
1473,Harry Wilson,5,2024-2025,27,wls WAL,Fulham,eng Premier League,19,839,9.3,8,11,3,5,1,6,5,0,0,0,FWMF,c6dc9ecd,Rotational Player
1474,Saša Lukić,5,2021-2022,24,rs SRB,Torino,it Serie A,35,2982,33.1,34,1,0,5,4,9,2,3,3,0,MF,c6e8cf1f,Full Starter
1475,Adrien Thomasson,5,2022-2023,28,fr FRA,2 Teams,fr Ligue 1,35,2215,24.6,26,9,0,5,7,12,5,0,0,0,MF,c76b7567,Full Starter
1476,Adrien Thomasson,5,2020-2021,26,fr FRA,Strasbourg,fr Ligue 1,37,2624,29.2,31,6,0,5,1,6,5,0,0,0,MFFW,c76b7567,Full Starter
1477,Kelechi Iheanacho,5,2022-2023,25,ng NGA,Leicester City,eng Premier League,28,1127,12.5,11,17,7,5,5,10,4,1,1,0,FWMF,c92e1a31,Rotational Player
1478,Brais Méndez,5,2023-2024,26,es ESP,Real Sociedad,es La Liga,32,2413,26.8,27,5,1,5,6,11,5,0,0,0,MFFW,c9e39d91,Full Starter
1479,Patson Daka,5,2021-2022,22,zm ZAM,Leicester City,eng Premier League,23,1159,12.9,13,10,13,5,3,8,5,0,0,0,FW,ca45605e,Rotational Player
1480,Lucas Höler,5,2022-2023,28,de GER,Freiburg,de Bundesliga,26,1503,16.7,16,10,0,5,2,7,5,0,0,0,FWMF,ca618d23,Rotational Player
1481,Leon Goretzka,5,2020-2021,25,de GER,Bayern Munich,de Bundesliga,24,1705,18.9,18,6,0,5,5,10,5,0,0,0,MF,cc86b9a3,Rotational Player
1482,André Hahn,5,2021-2022,30,de GER,Augsburg,de Bundesliga,32,2101,23.3,25,7,0,5,2,7,5,0,0,0,MFFW,cd82452e,Rotational Player
1483,Kurt Zouma,5,2020-2021,25,fr FRA,Chelsea,eng Premier League,24,2029,22.5,22,2,11,5,0,5,5,0,0,0,DF,ce4246f5,Full Starter
1484,Danny Welbeck,5,2023-2024,32,eng ENG,Brighton,eng Premier League,29,1693,18.8,21,8,1,5,1,6,5,0,0,0,FWMF,ce5143da,Rotational Player
1485,Ritsu Doan,5,2022-2023,24,jp JPN,Freiburg,de Bundesliga,33,2424,26.9,30,3,0,5,4,9,5,0,0,0,MFFW,d01bbb6f,Full Starter
1486,Ritsu Doan,5,2020-2021,22,jp JPN,Arminia,de Bundesliga,34,2768,30.8,33,1,0,5,2,7,5,0,0,0,MFFW,d01bbb6f,Full Starter
1487,Mikel Merino,5,2023-2024,27,es ESP,Real Sociedad,es La Liga,32,2482,27.6,27,5,3,5,3,8,5,0,0,0,MF,d080ed5e,Full Starter
1488,Yussuf Poulsen,5,2020-2021,26,dk DEN,RB Leipzig,de Bundesliga,27,1354,15.0,14,13,3,5,4,9,5,0,0,0,FW,d2416c2e,Rotational Player
1489,Yussuf Poulsen,5,2023-2024,29,dk DEN,RB Leipzig,de Bundesliga,28,1217,13.5,12,16,3,5,2,7,5,0,0,0,FW,d2416c2e,Rotational Player
1490,Leonardo Pavoletti,5,2021-2022,32,it ITA,Cagliari,it Serie A,33,1518,16.9,14,19,2,5,1,6,5,0,0,0,FW,d37b0350,Rotational Player
1491,Theo Hernández,5,2021-2022,23,fr FRA,Milan,it Serie A,32,2711,30.1,30,2,0,5,5,10,4,1,2,1,DF,d4c9725f,Full Starter
1492,Theo Hernández,5,2023-2024,25,fr FRA,Milan,it Serie A,32,2791,31.0,31,1,0,5,4,9,4,1,2,1,DF,d4c9725f,Full Starter
1493,Marquinhos,5,2021-2022,27,br BRA,Paris S-G,fr Ligue 1,32,2861,31.8,32,0,1,5,0,5,5,0,0,0,DF,d5f2f82b,Full Starter
1494,Florian Niederlechner,5,2020-2021,29,de GER,Augsburg,de Bundesliga,28,1737,19.3,21,7,3,5,4,9,5,0,0,0,FW,d6862409,Rotational Player
1495,Florian Niederlechner,5,2021-2022,30,de GER,Augsburg,de Bundesliga,26,1165,12.9,13,13,1,5,3,8,5,0,0,0,FW,d6862409,Rotational Player
1496,Florian Niederlechner,5,2022-2023,31,de GER,2 Teams,de Bundesliga,30,1691,18.8,21,9,2,5,1,6,5,0,0,0,FWMF,d6862409,Rotational Player
1497,Mattia Zaccagni,5,2020-2021,25,it ITA,Hellas Verona,it Serie A,36,2609,29.0,33,3,1,5,5,10,4,1,1,0,MF,d85c238b,Full Starter
1498,Scott McTominay,5,2024-2025,27,sct SCO,2 Teams,2 Comps,21,1633,18.1,18,3,0,5,2,7,5,0,0,0,MF,d93c2511,Rotational Player
1499,Guillermo Maripán,5,2020-2021,26,cl CHI,Monaco,fr Ligue 1,28,2089,23.2,22,6,5,5,1,6,5,0,0,0,DF,d9764034,Rotational Player
1500,Giacomo Bonaventura,5,2022-2023,32,it ITA,Fiorentina,it Serie A,30,1911,21.2,21,9,3,5,1,6,5,0,0,0,MF,d995ed27,Full Starter
1501,Álex Berenguer,5,2024-2025,29,es ESP,Athletic Club,es La Liga,20,1185,13.2,14,6,1,5,4,9,5,0,1,1,FWMF,dc1c2fce,Rotational Player
1502,Luca Mazzitelli,5,2023-2024,27,it ITA,Frosinone,it Serie A,29,2210,24.6,26,3,3,5,0,5,5,0,0,0,MF,dc61b402,Full Starter
1503,Amine Adli,5,2022-2023,22,ma MAR,Leverkusen,de Bundesliga,26,1435,15.9,16,10,1,5,3,8,5,0,0,0,FWMF,dcfb17f4,Rotational Player
1504,Henrikh Mkhitaryan,5,2021-2022,32,am ARM,Roma,it Serie A,31,2495,27.7,29,2,1,5,6,11,5,0,0,0,MFFW,dd0daf32,Full Starter
1505,Deniz Undav,5,2022-2023,26,de GER,Brighton,eng Premier League,22,628,7.0,6,16,14,5,0,5,5,0,0,0,FWMF,dd549382,Rotational Player
1506,Renato Steffen,5,2020-2021,28,ch SUI,Wolfsburg,de Bundesliga,21,1566,17.4,19,2,0,5,4,9,5,0,0,0,FWMF,dd669209,Rotational Player
1507,Silas Katompa,5,2023-2024,24,cd COD,Stuttgart,de Bundesliga,27,900,10.0,8,19,1,5,2,7,5,0,1,1,FWMF,de4cac2d,Rotational Player
1508,Silas Katompa,5,2022-2023,23,cd COD,Stuttgart,de Bundesliga,30,1992,22.1,23,7,0,5,2,7,4,1,1,0,FWMF,de4cac2d,Rotational Player
1509,Khvicha Kvaratskhelia,5,2024-2025,23,ge GEO,2 Teams,2 Comps,18,1260,14.0,16,2,0,5,4,9,4,1,1,0,FWMF,dea88efd,Full Starter
1510,Paulo Dybala,5,2024-2025,30,ar ARG,Roma,it Serie A,19,1209,13.4,14,5,1,5,2,7,3,2,2,0,FWMF,e0921a4f,Rotational Player
1511,Robert Andrich,5,2020-2021,25,de GER,Union Berlin,de Bundesliga,29,2526,28.1,29,0,0,5,2,7,5,0,0,0,MF,e0b113a7,Rotational Player
1512,Nathan N'Goumou,5,2023-2024,23,fr FRA,Gladbach,de Bundesliga,32,1385,15.4,14,18,2,5,2,7,5,0,0,0,FWMF,e110ea4b,Rotational Player
1513,Fabian Klos,5,2020-2021,32,de GER,Arminia,de Bundesliga,34,2709,30.1,32,2,0,5,2,7,4,1,2,1,FW,e21042ae,Rotational Player
1514,Achraf Hakimi,5,2022-2023,23,ma MAR,Paris S-G,fr Ligue 1,28,2053,22.8,23,5,1,5,3,8,5,0,0,0,DFMF,e42d61c7,Rotational Player
1515,Gervinho,5,2020-2021,33,ci CIV,Parma,it Serie A,27,2021,22.5,25,2,1,5,1,6,5,0,0,0,FW,e468c053,Rotational Player
1516,Taiwo Awoniyi,5,2020-2021,22,ng NGA,Union Berlin,de Bundesliga,21,1359,15.1,16,5,1,5,2,7,5,0,0,0,FW,e5478b87,Rotational Player
1517,Faitout Maouassa,5,2022-2023,24,fr FRA,Montpellier,fr Ligue 1,33,1923,21.4,23,10,0,5,5,10,5,0,0,0,FWDF,e54a9890,Rotational Player
1518,Kevin Stöger,5,2022-2023,28,at AUT,Bochum,de Bundesliga,32,2599,28.9,29,3,0,5,3,8,2,3,3,0,MF,e5649a78,Rotational Player
1519,Mario Pašalić,5,2022-2023,27,hr CRO,Atalanta,it Serie A,32,1769,19.7,24,8,2,5,2,7,5,0,0,0,MFFW,e599253a,Rotational Player
1520,Gonçalo Guedes,5,2020-2021,23,pt POR,Valencia,es La Liga,31,2287,25.4,27,4,5,5,5,10,5,0,0,0,MFFW,e6bc67d7,Rotational Player
1521,Callum Robinson,5,2020-2021,25,ie IRL,West Brom,eng Premier League,28,1560,17.3,20,8,10,5,0,5,5,0,0,0,FWMF,e75750a3,Rotational Player
1522,Chancel Mbemba,5,2022-2023,27,cd COD,Marseille,fr Ligue 1,36,2849,31.7,32,4,1,5,0,5,5,0,0,0,DF,e76cb9cc,Full Starter
1523,Cyle Larin,5,2024-2025,29,ca CAN,Mallorca,es La Liga,18,1120,12.4,15,3,2,5,2,7,4,1,1,0,FW,e7af9060,Rotational Player
1524,Florian Wirtz,5,2020-2021,17,de GER,Leverkusen,de Bundesliga,29,2224,24.7,25,4,0,5,6,11,5,0,0,0,MF,e7fcf289,Rotational Player
1525,David Datro Fofana,5,2023-2024,20,ci CIV,2 Teams,2 Comps,27,1561,17.3,18,9,1,5,1,6,5,0,0,0,FW,e82900ef,Rotational Player
1526,João Pedro,5,2024-2025,22,br BRA,Brighton,eng Premier League,17,1295,14.4,15,2,0,5,5,10,4,1,1,0,FWMF,e8832875,Rotational Player
1527,Kiké,5,2021-2022,31,es ESP,Osasuna,es La Liga,33,1862,20.7,18,15,1,5,1,6,4,1,1,0,FW,e897d8ba,Rotational Player
1528,Alexander Sørloth,5,2020-2021,24,no NOR,RB Leipzig,de Bundesliga,29,1443,16.0,13,16,4,5,3,8,5,0,1,1,FW,e92cd3f7,Rotational Player
1529,Luis Rioja,5,2023-2024,29,es ESP,Alavés,es La Liga,37,2498,27.8,31,6,1,5,4,9,2,3,4,1,FWMF,eb3dd471,Rotational Player
1530,Fidel,5,2021-2022,31,es ESP,Elche,es La Liga,33,2261,25.1,29,4,1,5,6,11,4,1,1,0,MF,eb82b6f1,Full Starter
1531,Filip Đuričić,5,2020-2021,28,rs SRB,Sassuolo,it Serie A,32,2079,23.1,27,5,1,5,4,9,4,1,1,0,MFFW,eccbe56a,Full Starter
1532,Darwin Machís,5,2020-2021,27,ve VEN,Granada,es La Liga,32,2026,22.5,21,11,0,5,5,10,5,0,1,1,FWMF,ed6ea4d9,Rotational Player
1533,Ermedin Demirović,5,2020-2021,22,ba BIH,Freiburg,de Bundesliga,30,1498,16.6,19,11,2,5,6,11,5,0,0,0,FW,ed79b7d3,Rotational Player
1534,Luis Javier Suárez,5,2020-2021,22,co COL,Granada,es La Liga,27,1666,18.5,18,9,0,5,1,6,5,0,0,0,FWMF,eeba07f8,Rotational Player
1535,Dany Mota,5,2022-2023,24,pt POR,Monza,it Serie A,29,1912,21.2,21,8,2,5,1,6,5,0,0,0,FWMF,efc9e31f,Rotational Player
1536,Musa Al-Taamari,5,2023-2024,26,jo JOR,Montpellier,fr Ligue 1,27,1928,21.4,24,3,0,5,2,7,5,0,0,0,FW,f15f8b2b,Rotational Player
1537,Nathan Tella,5,2023-2024,24,ng NGA,Leverkusen,de Bundesliga,24,819,9.1,8,16,8,5,2,7,5,0,0,0,DFMF,f1e94cd6,Bench Player
1538,Karim Onisiwo,5,2021-2022,29,at AUT,Mainz 05,de Bundesliga,31,2361,26.2,28,3,0,5,8,13,5,0,0,0,FW,f26834c7,Rotational Player
1539,Che Adams,5,2022-2023,26,sct SCO,Southampton,eng Premier League,28,1992,22.1,23,5,1,5,3,8,5,0,0,0,FW,f2bf1b0f,Rotational Player
1540,Junior Messias,5,2022-2023,31,br BRA,Milan,it Serie A,25,1498,16.6,19,6,4,5,2,7,5,0,0,0,FWDF,f49c4ae9,Rotational Player
1541,Junior Messias,5,2021-2022,30,br BRA,Milan,it Serie A,26,1428,15.9,14,12,1,5,2,7,5,0,0,0,FWMF,f49c4ae9,Rotational Player
1542,Pierre Lees-Melou,5,2022-2023,29,fr FRA,Brest,fr Ligue 1,32,2767,30.7,32,0,0,5,5,10,5,0,0,0,MF,f5044e54,Full Starter
1543,Yusuf Yazıcı,5,2023-2024,26,tr TUR,Lille,fr Ligue 1,27,1312,14.6,16,11,3,5,2,7,5,0,0,0,MFFW,f5c8b425,Rotational Player
1544,Danilho Doekhi,5,2022-2023,24,nl NED,Union Berlin,de Bundesliga,25,2216,24.6,25,0,4,5,1,6,5,0,0,0,DF,f67c9d29,Rotational Player
1545,Keven Schlotterbeck,5,2023-2024,26,de GER,2 Teams,de Bundesliga,27,2185,24.3,24,3,3,5,1,6,5,0,0,0,DF,f6bdc830,Rotational Player
1546,Enzo Millot,5,2023-2024,21,fr FRA,Stuttgart,de Bundesliga,31,2241,24.9,27,4,1,5,4,9,4,1,1,0,MFFW,f76022e7,Rotational Player
1547,Lyle Foster,5,2023-2024,22,za RSA,Burnley,eng Premier League,24,1899,21.1,22,2,0,5,3,8,5,0,0,0,FWMF,f84a807c,Rotational Player
1548,Nils Petersen,5,2021-2022,32,de GER,Freiburg,de Bundesliga,22,580,6.4,3,19,5,5,1,6,5,0,0,0,FW,f93e6e94,Bench Player
1549,Marco Richter,5,2021-2022,23,de GER,Hertha BSC,de Bundesliga,30,1704,18.9,19,11,2,5,1,6,5,0,0,0,FWMF,f972644c,Rotational Player
1550,Giovanni Fabbian,5,2023-2024,20,it ITA,Bologna,it Serie A,27,1057,11.7,11,16,11,5,2,7,5,0,0,0,MFFW,f97f9188,Rotational Player
1551,Lovro Majer,5,2023-2024,25,hr CRO,2 Teams,2 Comps,33,2122,23.6,25,8,2,5,5,10,3,2,2,0,MF,fc46aab1,Rotational Player
1552,Moussa Konaté,5,2020-2021,27,sn SEN,Dijon,fr Ligue 1,27,1196,13.3,13,14,1,5,1,6,4,1,2,1,FW,fcbcbd94,Rotational Player
1553,Abdallah Sima,5,2022-2023,21,sn SEN,Angers,fr Ligue 1,34,1836,20.4,19,15,0,5,1,6,5,0,0,0,FW,fdbde523,Rotational Player
1554,Ishak Belfodil,5,2021-2022,29,dz ALG,Hertha BSC,de Bundesliga,26,1636,18.2,17,9,4,5,2,7,4,1,1,0,FW,ff182fdc,Rotational Player
1555,Moussa Niakhate,4,2021-2022,25,sn SEN,Mainz 05,de Bundesliga,30,2567,28.5,29,1,0,4,0,4,2,2,2,0,DF,00242715,Full Starter
1556,Leandro Barreiro Martins,4,2022-2023,22,lu LUX,Mainz 05,de Bundesliga,31,2141,23.8,25,6,2,4,3,7,4,0,0,0,MF,00242b75,Full Starter
1557,Leandro Barreiro Martins,4,2023-2024,23,lu LUX,Mainz 05,de Bundesliga,31,2606,29.0,29,2,0,4,1,5,4,0,0,0,MF,00242b75,Full Starter
1558,Niclas Eliasson,4,2020-2021,24,se SWE,Nîmes,fr Ligue 1,30,1799,20.0,19,11,2,4,3,7,4,0,0,0,MFFW,0033fb1b,Rotational Player
1559,Tete Morente,4,2022-2023,25,es ESP,Elche,es La Liga,32,2068,23.0,23,9,4,4,0,4,4,0,0,0,MFDF,004d185e,Rotational Player
1560,Konstantinos Mavropanos,4,2021-2022,23,gr GRE,Stuttgart,de Bundesliga,31,2705,30.1,31,0,0,4,0,4,4,0,0,0,DF,00963611,Full Starter
1561,Julian Ryerson,4,2023-2024,25,no NOR,Dortmund,de Bundesliga,21,1767,19.6,20,1,3,4,1,5,4,0,0,0,DF,009a4f60,Rotational Player
1562,Przemysław Frankowski,4,2024-2025,29,pl POL,Lens,fr Ligue 1,17,1297,14.4,15,2,2,4,2,6,2,2,2,0,DF,00a8d210,Rotational Player
1563,Nemanja Maksimović,4,2023-2024,28,rs SRB,Getafe,es La Liga,37,3265,36.3,37,0,0,4,0,4,4,0,0,0,MF,00b28772,Full Starter
1564,Faride Alidou,4,2023-2024,22,de GER,Köln,de Bundesliga,26,1282,14.2,14,12,2,4,0,4,4,0,0,0,FWMF,00f518d8,Rotational Player
1565,Mohamed Lamine Bayo,4,2022-2023,24,gn GUI,Lille,fr Ligue 1,27,651,7.2,6,21,8,4,1,5,4,0,0,0,FWMF,01870104,Rotational Player
1566,Kieffer Moore,4,2022-2023,29,wls WAL,Bournemouth,eng Premier League,27,1279,14.2,12,15,8,4,0,4,4,0,0,0,FW,01ce9e70,Rotational Player
1567,Raúl de Tomás,4,2022-2023,27,es ESP,Rayo Vallecano,es La Liga,19,805,8.9,9,10,2,4,0,4,3,1,2,1,FW,02ef8778,Rotational Player
1568,Andrea Petagna,4,2022-2023,27,it ITA,Monza,it Serie A,31,1663,18.5,19,12,2,4,5,9,3,1,1,0,FW,03f946ed,Rotational Player
1569,Andrea Petagna,4,2020-2021,25,it ITA,Napoli,it Serie A,26,964,10.7,9,17,5,4,3,7,4,0,0,0,FW,03f946ed,Rotational Player
1570,Raphaël Guerreiro,4,2022-2023,28,pt POR,Dortmund,de Bundesliga,27,2290,25.4,26,1,4,4,12,16,4,0,0,0,DFMF,048a1cbc,Rotational Player
1571,Raphaël Guerreiro,4,2021-2022,27,pt POR,Dortmund,de Bundesliga,23,1795,19.9,21,2,0,4,2,6,3,1,1,0,DF,048a1cbc,Rotational Player
1572,Lorenzo Colombo,4,2023-2024,21,it ITA,2 Teams,it Serie A,25,1359,15.1,16,9,13,4,1,5,4,0,0,0,FW,04df29a5,Rotational Player
1573,Tanguy Coulibaly,4,2022-2023,21,fr FRA,Stuttgart,de Bundesliga,14,326,3.6,0,14,8,4,0,4,3,1,1,0,FWDF,05ba9d7c,Bench Player
1574,Cameron Archer,4,2023-2024,22,eng ENG,2 Teams,eng Premier League,30,1838,20.4,21,9,1,4,1,5,4,0,0,0,FWMF,05e8ca6d,Rotational Player
1575,Mohammed Daramy,4,2023-2024,21,dk DEN,Reims,fr Ligue 1,25,1648,18.3,19,6,0,4,5,9,3,1,1,0,FWMF,06a1d642,Rotational Player
1576,Sergio Akieme,4,2023-2024,25,es ESP,2 Teams,2 Comps,32,2493,27.7,27,5,3,4,0,4,4,0,0,0,DF,06efa9dc,Full Starter
1577,Daniel Mosquera,4,2024-2025,24,co COL,Hellas Verona,it Serie A,19,603,6.7,4,15,2,4,1,5,4,0,0,0,FW,091b9eb8,Bench Player
1578,Kevin Lasagna,4,2020-2021,27,it ITA,2 Teams,it Serie A,36,2370,26.3,26,10,1,4,1,5,4,0,0,0,FW,09538fdb,Rotational Player
1579,Juan Cuadrado,4,2021-2022,33,co COL,Juventus,it Serie A,33,2487,27.6,28,5,2,4,3,7,4,0,0,0,DFMF,0ab1f153,Full Starter
1580,Cédric Bakambu,4,2021-2022,30,cd COD,Marseille,fr Ligue 1,12,356,4.0,5,7,3,4,0,4,4,0,0,0,FW,0af4dcf0,Bench Player
1581,Breel Embolo,4,2024-2025,27,ch SUI,Monaco,fr Ligue 1,16,921,10.2,10,6,3,4,2,6,4,0,0,0,FW,0b4f388a,Rotational Player
1582,Ansu Fati,4,2020-2021,17,es ESP,Barcelona,es La Liga,7,431,4.8,6,1,0,4,0,4,4,0,0,0,FW,0ba976e4,Bench Player
1583,Ansu Fati,4,2021-2022,18,es ESP,Barcelona,es La Liga,10,336,3.7,3,7,0,4,0,4,4,0,0,0,FW,0ba976e4,Bench Player
1584,Romain Del Castillo,4,2024-2025,28,fr FRA,Brest,fr Ligue 1,17,955,10.6,11,6,0,4,3,7,1,3,4,1,FW,0be95d34,Rotational Player
1585,Lukas Nmecha,4,2022-2023,23,de GER,Wolfsburg,de Bundesliga,16,899,10.0,10,6,2,4,0,4,4,0,0,0,FW,0cc5f4a5,Bench Player
1586,Pedri,4,2023-2024,20,es ESP,Barcelona,es La Liga,24,1476,16.4,16,8,0,4,2,6,4,0,0,0,MFFW,0d9b2d31,Rotational Player
1587,Pedri,4,2024-2025,21,es ESP,Barcelona,es La Liga,20,1515,16.8,18,2,0,4,2,6,4,0,0,0,MF,0d9b2d31,Rotational Player
1588,Theo Bongonda,4,2022-2023,26,cd COD,Cádiz,es La Liga,31,1938,21.5,24,7,5,4,3,7,3,1,1,0,MFFW,0da6a13e,Rotational Player
1589,Dani Gómez,4,2021-2022,23,es ESP,Levante,es La Liga,28,1063,11.8,11,17,5,4,2,6,4,0,0,0,FW,0e5ddc7c,Rotational Player
1590,Eric Maxim Choupo-Moting,4,2021-2022,32,cm CMR,Bayern Munich,de Bundesliga,20,377,4.2,1,19,2,4,2,6,4,0,0,0,FWMF,0e6bc38c,Bench Player
1591,Bobby Reid,4,2022-2023,29,jm JAM,Fulham,eng Premier League,36,2475,27.5,29,7,1,4,1,5,4,0,0,0,FWDF,0f7533cd,Rotational Player
1592,Tommaso Baldanzi,4,2022-2023,19,it ITA,Empoli,it Serie A,26,1772,19.7,24,2,5,4,0,4,4,0,0,0,MF,102e2599,Rotational Player
1593,Sardar Azmoun,4,2022-2023,27,ir IRN,Leverkusen,de Bundesliga,23,927,10.3,8,15,3,4,1,5,4,0,0,0,FWMF,10549b49,Bench Player
1594,Jean-Ricner Bellegarde,4,2023-2024,25,fr FRA,2 Teams,2 Comps,25,1227,13.6,13,12,0,4,3,7,4,0,0,0,MFFW,10f0fdd3,Rotational Player
1595,Marvin Pieringer,4,2024-2025,24,de GER,Heidenheim,de Bundesliga,16,1124,12.5,14,2,0,4,2,6,3,1,1,0,FWMF,11407d95,Rotational Player
1596,Aymeric Laporte,4,2021-2022,27,es ESP,Manchester City,eng Premier League,33,2828,31.4,33,0,2,4,0,4,4,0,0,0,DF,119b9a8e,Full Starter
1597,Davie Selke,4,2021-2022,26,de GER,Hertha BSC,de Bundesliga,25,1004,11.2,10,15,4,4,0,4,3,1,1,0,FW,1238a3f9,Rotational Player
1598,Denis Suárez,4,2021-2022,27,es ESP,Celta Vigo,es La Liga,38,2819,31.3,33,5,0,4,6,10,4,0,0,0,MF,12c50af5,Full Starter
1599,Samu Castillejo,4,2022-2023,27,es ESP,Valencia,es La Liga,25,1362,15.1,17,8,4,4,0,4,4,0,0,0,FWMF,130a7a3f,Rotational Player
1600,Jamie Leweling,4,2023-2024,22,de GER,Stuttgart,de Bundesliga,34,1523,16.9,17,17,0,4,4,8,4,0,0,0,FWMF,13fe7b69,Rotational Player
1601,Jasmin Kurtić,4,2020-2021,31,si SVN,Parma,it Serie A,34,2739,30.4,31,3,0,4,0,4,4,0,0,0,MF,144607cc,Full Starter
1602,Diego Farias,4,2020-2021,30,br BRA,Spezia,it Serie A,29,1514,16.8,17,12,4,4,2,6,4,0,0,0,FW,157d29b6,Rotational Player
1603,Daichi Kamada,4,2021-2022,24,jp JPN,Eint Frankfurt,de Bundesliga,32,2139,23.8,23,9,1,4,3,7,4,0,0,0,MF,15b287da,Rotational Player
1604,Burak Yılmaz,4,2021-2022,36,tr TUR,Lille,fr Ligue 1,31,2211,24.6,25,6,1,4,3,7,2,2,2,0,FW,165a2e40,Rotational Player
1605,Takefusa Kubo,4,2024-2025,23,jp JPN,Real Sociedad,es La Liga,21,1389,15.4,15,6,0,4,0,4,4,0,0,0,MFFW,16aa3654,Rotational Player
1606,Olivier Giroud,4,2020-2021,33,fr FRA,Chelsea,eng Premier League,17,748,8.3,8,9,18,4,0,4,4,0,0,0,FW,16ceb862,Rotational Player
1607,Iker Muñoz,4,2023-2024,20,es ESP,Osasuna,es La Liga,28,1854,20.6,20,8,10,4,0,4,4,0,0,0,MF,175ece4c,Rotational Player
1608,Emile Smith Rowe,4,2024-2025,24,eng ENG,Fulham,eng Premier League,21,1363,15.1,17,4,0,4,2,6,4,0,0,0,MF,17695062,Rotational Player
1609,Krzysztof Piątek,4,2021-2022,26,pl POL,2 Teams,2 Comps,23,1080,12.0,13,10,7,4,0,4,4,0,1,1,FW,17f3620a,Rotational Player
1610,Krzysztof Piątek,4,2022-2023,27,pl POL,Salernitana,it Serie A,33,2140,23.8,23,10,1,4,5,9,3,1,1,0,FW,17f3620a,Rotational Player
1611,Federico Gatti,4,2023-2024,25,it ITA,Juventus,it Serie A,32,2637,29.3,30,2,5,4,0,4,4,0,0,0,DF,18dd3219,Full Starter
1612,Rubén Sobrino,4,2021-2022,29,es ESP,2 Teams,es La Liga,34,1875,20.8,19,15,3,4,1,5,4,0,0,0,MF,19b776e9,Rotational Player
1613,Ángel Di María,4,2022-2023,34,ar ARG,Juventus,it Serie A,26,1363,15.1,15,11,1,4,4,8,3,1,1,0,FWMF,19cda00b,Rotational Player
1614,Ángel Di María,4,2020-2021,32,ar ARG,Paris S-G,fr Ligue 1,27,1853,20.6,23,4,2,4,9,13,4,0,0,0,FWMF,19cda00b,Rotational Player
1615,Julian Draxler,4,2020-2021,26,de GER,Paris S-G,fr Ligue 1,24,1064,11.8,12,12,5,4,3,7,4,0,0,0,MFFW,1a992676,Bench Player
1616,Marco Sau,4,2020-2021,32,it ITA,Benevento,it Serie A,24,785,8.7,9,15,6,4,2,6,3,1,1,0,MFFW,1ad1f50d,Bench Player
1617,Christian Pulisic,4,2020-2021,21,us USA,Chelsea,eng Premier League,27,1738,19.3,18,9,2,4,2,6,4,0,0,0,FWMF,1bf33a9a,Rotational Player
1618,Declan Rice,4,2022-2023,23,eng ENG,West Ham,eng Premier League,37,3273,36.4,36,1,0,4,1,5,4,0,1,1,MF,1c7012b8,Full Starter
1619,Damien Da Silva,4,2020-2021,32,fr FRA,Rennes,fr Ligue 1,30,2661,29.6,30,0,3,4,0,4,4,0,0,0,DF,1ec7e1c5,Full Starter
1620,Willi Orban,4,2020-2021,27,hu HUN,RB Leipzig,de Bundesliga,29,2363,26.3,25,4,4,4,1,5,4,0,0,0,DF,20030c06,Full Starter
1621,Willi Orban,4,2022-2023,29,hu HUN,RB Leipzig,de Bundesliga,33,2951,32.8,33,0,1,4,0,4,4,0,0,0,DF,20030c06,Full Starter
1622,Ander Barrenetxea,4,2023-2024,21,es ESP,Real Sociedad,es La Liga,29,1427,15.9,20,9,1,4,1,5,4,0,0,0,FWMF,200e89e1,Rotational Player
1623,Jakub Kamiński,4,2022-2023,20,pl POL,Wolfsburg,de Bundesliga,31,2058,22.9,25,6,2,4,2,6,4,0,0,0,FWDF,202b3b68,Rotational Player
1624,Rafael Leão,4,2024-2025,25,pt POR,Milan,it Serie A,19,1346,15.0,16,3,1,4,4,8,4,0,0,0,FW,20730eae,Full Starter
1625,Dennis Man,4,2024-2025,25,ro ROU,Parma,it Serie A,21,1542,17.1,18,3,0,4,3,7,4,0,0,0,FWMF,2079b3cc,Rotational Player
1626,Romano Schmid,4,2023-2024,23,at AUT,Werder Bremen,de Bundesliga,33,2601,28.9,30,3,0,4,6,10,4,0,0,0,MFFW,220ace7e,Full Starter
1627,Cristhian Stuani,4,2024-2025,37,uy URU,Girona,es La Liga,16,363,4.0,0,16,5,4,1,5,2,2,2,0,FW,220c11f1,Bench Player
1628,Nahuel Molina,4,2022-2023,24,ar ARG,Atlético Madrid,es La Liga,33,2867,31.9,33,0,1,4,2,6,4,0,0,0,DF,23610943,Full Starter
1629,Matty Cash,4,2021-2022,23,pl POL,Aston Villa,eng Premier League,38,3377,37.5,38,0,0,4,3,7,4,0,0,0,DF,2389cdc2,Full Starter
1630,Boulaye Dia,4,2023-2024,26,sn SEN,Salernitana,it Serie A,17,1143,12.7,12,5,1,4,0,4,3,1,1,0,FWMF,244bc2c8,Rotational Player
1631,Jake O'Brien,4,2023-2024,22,ie IRL,Lyon,fr Ligue 1,27,2369,26.3,27,0,4,4,2,6,4,0,0,0,DF,25f2ef01,Full Starter
1632,Wahbi Khazri,4,2022-2023,31,tn TUN,Montpellier,fr Ligue 1,27,1635,18.2,20,7,2,4,1,5,4,0,0,0,FWMF,2677a1de,Rotational Player
1633,Javi Puado,4,2021-2022,23,es ESP,Espanyol,es La Liga,30,2245,24.9,26,4,0,4,1,5,4,0,0,0,MFFW,2683eda7,Rotational Player
1634,Tahith Chong,4,2023-2024,23,nl NED,Luton Town,eng Premier League,33,1982,22.0,20,13,5,4,0,4,4,0,0,0,MFFW,2696b6a9,Rotational Player
1635,Romain Thomas,4,2020-2021,32,fr FRA,Angers,fr Ligue 1,34,3024,33.6,34,0,1,4,0,4,4,0,0,0,DF,275e2c51,Full Starter
1636,Maxence Lacroix,4,2023-2024,23,fr FRA,Wolfsburg,de Bundesliga,28,2362,26.2,27,1,0,4,1,5,4,0,0,0,DF,277c49ed,Full Starter
1637,Xavier Chavalerin,4,2022-2023,31,fr FRA,Troyes,fr Ligue 1,34,2426,27.0,25,9,3,4,2,6,4,0,0,0,MF,279ddf6a,Full Starter
1638,Mateusz Klich,4,2020-2021,30,pl POL,Leeds United,eng Premier League,35,2393,26.6,28,7,1,4,5,9,2,2,2,0,MF,282679b4,Full Starter
1639,Conor Coady,4,2021-2022,28,eng ENG,Wolves,eng Premier League,38,3361,37.3,38,0,0,4,0,4,4,0,0,0,DF,2928dca2,Full Starter
1640,Tomáš Čvančara,4,2023-2024,22,cz CZE,Gladbach,de Bundesliga,21,896,10.0,7,14,0,4,1,5,3,1,2,1,FW,298c8aa1,Bench Player
1641,Aaron Leya Iseka,4,2020-2021,22,be BEL,Metz,fr Ligue 1,21,1008,11.2,12,9,5,4,0,4,2,2,3,1,FW,29ef0f49,Rotational Player
1642,Benedict Hollerbach,4,2024-2025,23,de GER,Union Berlin,de Bundesliga,19,1435,15.9,18,1,0,4,1,5,4,0,0,0,MFFW,2a158218,Rotational Player
1643,Samuel Lino,4,2023-2024,23,br BRA,Atlético Madrid,es La Liga,34,2080,23.1,25,9,2,4,5,9,4,0,0,0,DFMF,2a295d33,Rotational Player
1644,Lukas Kübler,4,2024-2025,31,de GER,Freiburg,de Bundesliga,19,1491,16.6,19,0,0,4,0,4,4,0,0,0,DF,2a29eb9b,Rotational Player
1645,Mathieu Cafaro,4,2020-2021,23,fr FRA,Reims,fr Ligue 1,31,2074,23.0,27,4,3,4,2,6,4,0,0,0,MFFW,2a657da0,Full Starter
1646,Davide Frattesi,4,2021-2022,21,it ITA,Sassuolo,it Serie A,36,2854,31.7,35,1,0,4,3,7,4,0,0,0,MF,2a7d27c1,Rotational Player
1647,Davide Frattesi,4,2024-2025,24,it ITA,Inter,it Serie A,17,717,8.0,5,12,5,4,1,5,4,0,0,0,MF,2a7d27c1,Rotational Player
1648,Marshall Munetsi,4,2023-2024,27,zw ZIM,Reims,fr Ligue 1,27,2173,24.1,25,2,0,4,3,7,4,0,0,0,MF,2acf0cd7,Rotational Player
1649,Marshall Munetsi,4,2024-2025,28,zw ZIM,Reims,fr Ligue 1,18,1602,17.8,18,0,0,4,2,6,4,0,0,0,MF,2acf0cd7,Rotational Player
1650,Mario Lemina,4,2023-2024,29,ga GAB,Wolves,eng Premier League,35,2968,33.0,34,1,0,4,1,5,4,0,0,0,MF,2b471f99,Full Starter
1651,Anthony Gordon,4,2021-2022,20,eng ENG,Everton,eng Premier League,35,2285,25.4,25,10,2,4,2,6,4,0,0,0,MFFW,2bd83368,Rotational Player
1652,Anthony Gordon,4,2022-2023,21,eng ENG,2 Teams,eng Premier League,32,1582,17.6,16,16,1,4,0,4,4,0,0,0,FWMF,2bd83368,Rotational Player
1653,Ronald Araújo,4,2021-2022,22,uy URU,Barcelona,es La Liga,30,2272,25.2,25,5,1,4,0,4,4,0,0,0,DF,2bef2bca,Rotational Player
1654,Ozan Kabak,4,2023-2024,23,tr TUR,Hoffenheim,de Bundesliga,28,2282,25.4,28,0,1,4,0,4,4,0,0,0,DF,2d61d13a,Full Starter
1655,Stephy Mavididi,4,2022-2023,24,eng ENG,Montpellier,fr Ligue 1,26,1288,14.3,14,12,1,4,2,6,4,0,0,0,FW,30144daa,Rotational Player
1656,Philipp Lienhart,4,2020-2021,24,at AUT,Freiburg,de Bundesliga,34,2993,33.3,34,0,0,4,0,4,4,0,0,0,DF,302527b2,Full Starter
1657,Angeliño,4,2020-2021,23,es ESP,RB Leipzig,de Bundesliga,26,2161,24.0,24,2,2,4,4,8,4,0,0,0,DFFW,30941e96,Rotational Player
1658,Nabil Bentaleb,4,2022-2023,27,dz ALG,Angers,fr Ligue 1,30,2489,27.7,29,1,0,4,4,8,2,2,2,0,MF,3189f61a,Full Starter
1659,Yunis Abdelhamid,4,2023-2024,35,ma MAR,Reims,fr Ligue 1,31,2781,30.9,31,0,0,4,0,4,3,1,1,0,DF,32c2d95f,Full Starter
1660,Morgan Gibbs-White,4,2024-2025,24,eng ENG,Nott'ham Forest,eng Premier League,19,1499,16.7,19,0,0,4,4,8,4,0,0,0,MF,32f60ed8,Full Starter
1661,Jeffrey Schlupp,4,2021-2022,28,gh GHA,Crystal Palace,eng Premier League,32,1851,20.6,20,12,4,4,1,5,4,0,0,0,MFFW,3312f911,Rotational Player
1662,Pere Milla,4,2020-2021,27,es ESP,Elche,es La Liga,32,1981,22.0,22,10,5,4,3,7,4,0,0,0,FWMF,335039a2,Rotational Player
1663,Sergi Roberto,4,2022-2023,30,es ESP,Barcelona,es La Liga,23,1308,14.5,15,8,6,4,1,5,4,0,0,0,DFMF,335fa267,Rotational Player
1664,Giovanni Simeone,4,2022-2023,27,ar ARG,Napoli,it Serie A,25,406,4.5,1,24,10,4,1,5,4,0,0,0,FW,343c0d52,Rotational Player
1665,Edon Zhegrova,4,2024-2025,25,xk KVX,Lille,fr Ligue 1,12,978,10.9,12,0,0,4,1,5,4,0,0,0,FWMF,34a88e3e,Rotational Player
1666,Lee Jae-sung,4,2021-2022,28,kr KOR,Mainz 05,de Bundesliga,27,1436,16.0,19,8,2,4,3,7,4,0,0,0,MFFW,34b0387f,Rotational Player
1667,Nico Schlotterbeck,4,2021-2022,21,de GER,Freiburg,de Bundesliga,32,2785,30.9,32,0,0,4,1,5,4,0,0,0,DF,34e12499,Full Starter
1668,Nico Schlotterbeck,4,2022-2023,22,de GER,Dortmund,de Bundesliga,28,2252,25.0,27,1,3,4,5,9,4,0,0,0,DF,34e12499,Full Starter
1669,Marcos Senesi,4,2023-2024,26,ar ARG,Bournemouth,eng Premier League,31,2242,24.9,26,5,1,4,5,9,4,0,0,0,DF,35141f4c,Full Starter
1670,Wilson Odobert,4,2022-2023,17,fr FRA,Troyes,fr Ligue 1,32,1764,19.6,19,13,3,4,2,6,4,0,0,0,MFFW,35516eac,Rotational Player
1671,Tuta,4,2021-2022,22,br BRA,Eint Frankfurt,de Bundesliga,26,2183,24.3,26,0,4,4,0,4,4,0,0,0,DF,35d64857,Full Starter
1672,Ben White,4,2023-2024,25,eng ENG,Arsenal,eng Premier League,37,2988,33.2,35,2,0,4,4,8,4,0,0,0,DF,35e413f1,Full Starter
1673,Florian Neuhaus,4,2023-2024,26,de GER,Gladbach,de Bundesliga,25,1224,13.6,15,10,7,4,2,6,3,1,1,0,MF,36a59ba4,Rotational Player
1674,Florian Neuhaus,4,2021-2022,24,de GER,Gladbach,de Bundesliga,29,2121,23.6,24,5,5,4,4,8,4,0,0,0,MF,36a59ba4,Rotational Player
1675,Ramy Bensebaini,4,2021-2022,26,dz ALG,Gladbach,de Bundesliga,23,2020,22.4,22,1,0,4,1,5,2,2,2,0,DF,378825c7,Rotational Player
1676,Ramy Bensebaini,4,2020-2021,25,dz ALG,Gladbach,de Bundesliga,25,1811,20.1,20,5,1,4,0,4,3,1,1,0,DF,378825c7,Rotational Player
1677,Javier Guerra,4,2023-2024,20,es ESP,Valencia,es La Liga,36,2498,27.8,28,8,0,4,1,5,4,0,0,0,MF,3828f130,Full Starter
1678,Denis Zakaria,4,2023-2024,26,ch SUI,Monaco,fr Ligue 1,25,2137,23.7,24,1,0,4,0,4,4,0,0,0,MFDF,384d58d9,Rotational Player
1679,Jorge de Frutos,4,2024-2025,27,es ESP,Rayo Vallecano,es La Liga,21,1471,16.3,17,4,0,4,2,6,4,0,0,0,MFFW,38ce1150,Rotational Player
1680,Jorge de Frutos,4,2021-2022,24,es ESP,Levante,es La Liga,25,1760,19.6,20,5,0,4,7,11,4,0,0,0,MFFW,38ce1150,Rotational Player
1681,Jorge de Frutos,4,2020-2021,23,es ESP,Levante,es La Liga,37,2186,24.3,22,15,0,4,9,13,4,0,0,0,MF,38ce1150,Rotational Player
1682,Leandro Trossard,4,2024-2025,29,be BEL,Arsenal,eng Premier League,23,1366,15.2,15,8,0,4,4,8,4,0,0,0,FW,38ceb24a,Rotational Player
1683,Gonzalo Melero,4,2022-2023,28,es ESP,Almería,es La Liga,27,1855,20.6,24,3,2,4,3,7,3,1,1,0,MF,3902e91b,Rotational Player
1684,Sead Kolašinac,4,2022-2023,29,ba BIH,Marseille,fr Ligue 1,33,2214,24.6,26,7,0,4,1,5,4,0,0,0,DF,3935e52e,Full Starter
1685,Sammie Szmodics,4,2024-2025,28,ie IRL,Ipswich Town,eng Premier League,18,978,10.9,13,5,1,4,0,4,4,0,0,0,FWMF,39944392,Rotational Player
1686,Leon Bailey,4,2022-2023,24,jm JAM,Aston Villa,eng Premier League,33,1967,21.9,26,7,0,4,4,8,4,0,0,0,FWMF,3a233281,Rotational Player
1687,Ross Barkley,4,2022-2023,28,eng ENG,Nice,fr Ligue 1,27,960,10.7,9,18,4,4,2,6,4,0,0,0,MFFW,3a24769f,Rotational Player
1688,Riccardo Saponara,4,2022-2023,30,it ITA,Fiorentina,it Serie A,29,1208,13.4,14,15,8,4,3,7,4,0,0,0,FW,3bb7af3b,Rotational Player
1689,Eliesse Ben Seghir,4,2022-2023,17,ma MAR,Monaco,fr Ligue 1,19,1052,11.7,13,6,2,4,1,5,4,0,0,0,FWMF,3bd65247,Rotational Player
1690,Fabien Centonze,4,2021-2022,25,fr FRA,Metz,fr Ligue 1,19,1586,17.6,18,1,0,4,1,5,4,0,0,0,DF,3c6bbbab,Rotational Player
1691,Pedro,4,2022-2023,35,es ESP,Lazio,it Serie A,36,1898,21.1,17,19,0,4,3,7,4,0,0,0,FW,3ca7254a,Rotational Player
1692,David García,4,2021-2022,27,es ESP,Osasuna,es La Liga,35,3105,34.5,35,0,1,4,0,4,4,0,0,0,DF,3e42f707,Full Starter
1693,Bernardo Silva,4,2022-2023,27,pt POR,Manchester City,eng Premier League,34,2205,24.5,24,10,4,4,5,9,4,0,0,0,MFFW,3eb22ec9,Full Starter
1694,Martín Zubimendi,4,2023-2024,24,es ESP,Real Sociedad,es La Liga,31,2654,29.5,29,2,0,4,1,5,4,0,0,0,MF,3ee0dd59,Full Starter
1695,Gelson Martins,4,2021-2022,26,pt POR,Monaco,fr Ligue 1,32,1905,21.2,24,8,2,4,3,7,4,0,0,0,MFFW,3ef0fa48,Rotational Player
1696,André Silva,4,2022-2023,26,pt POR,RB Leipzig,de Bundesliga,31,1738,19.3,20,11,3,4,3,7,4,0,0,0,FW,3effaa34,Rotational Player
1697,Gonzalo Escalante,4,2022-2023,29,ar ARG,2 Teams,2 Comps,23,1676,18.6,20,3,6,4,2,6,4,0,0,0,MF,3f79a1c8,Rotational Player
1698,Milan Đurić,4,2024-2025,34,ba BIH,2 Teams,it Serie A,19,1339,14.9,14,5,0,4,1,5,4,0,0,0,FW,405f6586,Rotational Player
1699,Bamba Dieng,4,2023-2024,23,sn SEN,Lorient,fr Ligue 1,16,549,6.1,5,11,2,4,1,5,4,0,0,0,FW,40774c6b,Bench Player
1700,Bamba Dieng,4,2022-2023,22,sn SEN,2 Teams,fr Ligue 1,25,941,10.5,10,15,1,4,0,4,3,1,1,0,FWMF,40774c6b,Bench Player
1701,Brahim Díaz,4,2020-2021,20,ma MAR,Milan,it Serie A,27,1228,13.6,15,12,7,4,3,7,4,0,0,0,MFFW,407feb71,Rotational Player
1702,Jan Bednarek,4,2021-2022,25,pl POL,Southampton,eng Premier League,31,2629,29.2,30,1,6,4,0,4,4,0,0,0,DF,4115ce4e,Full Starter
1703,Kévin Gameiro,4,2023-2024,36,fr FRA,Strasbourg,fr Ligue 1,27,1346,15.0,15,12,2,4,2,6,2,2,2,0,FWMF,42276181,Rotational Player
1704,Kévin Gameiro,4,2020-2021,33,fr FRA,Valencia,es La Liga,27,1077,12.0,10,17,3,4,1,5,4,0,0,0,FW,42276181,Rotational Player
1705,Jonathan Ikone,4,2022-2023,24,fr FRA,Fiorentina,it Serie A,33,2007,22.3,24,9,5,4,4,8,4,0,0,0,FW,42eaa028,Rotational Player
1706,Jonathan Ikone,4,2020-2021,22,fr FRA,Lille,fr Ligue 1,37,2177,24.2,26,11,0,4,5,9,3,1,1,0,MFFW,42eaa028,Rotational Player
1707,Joshua King,4,2024-2025,32,no NOR,Toulouse,fr Ligue 1,17,1108,12.3,14,3,0,4,2,6,4,0,0,0,FWMF,43458538,Rotational Player
1708,Mauro Icardi,4,2021-2022,28,ar ARG,Paris S-G,fr Ligue 1,24,1027,11.4,10,14,5,4,0,4,4,0,0,0,FW,43b78598,Rotational Player
1709,Obite N'Dicka,4,2021-2022,21,ci CIV,Eint Frankfurt,de Bundesliga,32,2857,31.7,32,0,1,4,4,8,4,0,0,0,DF,441197b8,Full Starter
1710,Oumar Diakité,4,2024-2025,20,ci CIV,Reims,fr Ligue 1,18,1304,14.5,17,1,0,4,1,5,4,0,0,0,FW,44435c8f,Rotational Player
1711,Demarai Gray,4,2022-2023,26,jm JAM,Everton,eng Premier League,33,2507,27.9,27,6,5,4,1,5,2,2,2,0,FWMF,4468ec10,Full Starter
1712,Rúben Neves,4,2021-2022,24,pt POR,Wolves,eng Premier League,33,2661,29.6,31,2,0,4,2,6,4,0,0,0,MF,44bfb6c5,Full Starter
1713,Benjamin Pavard,4,2022-2023,26,fr FRA,Bayern Munich,de Bundesliga,30,2431,27.0,27,3,3,4,1,5,4,0,0,0,DF,45a03961,Full Starter
1714,Marco Asensio,4,2023-2024,27,es ESP,Paris S-G,fr Ligue 1,19,1113,12.4,13,6,5,4,5,9,4,0,0,0,MFFW,45af8a54,Rotational Player
1715,Nathanael Mbuku,4,2020-2021,18,cd COD,Reims,fr Ligue 1,32,2210,24.6,28,4,2,4,1,5,4,0,0,0,MFFW,46750e9c,Full Starter
1716,Facundo Buonanotte,4,2024-2025,19,ar ARG,Leicester City,eng Premier League,20,1146,12.7,12,8,1,4,2,6,4,0,0,0,FWMF,468a7a91,Rotational Player
1717,Josh Brownhill,4,2023-2024,27,eng ENG,Burnley,eng Premier League,33,2252,25.0,23,10,4,4,2,6,4,0,0,0,MF,47369df8,Rotational Player
1718,Adnan Januzaj,4,2020-2021,25,be BEL,Real Sociedad,es La Liga,27,1014,11.3,12,15,5,4,5,9,1,3,3,0,FWMF,4737cebe,Rotational Player
1719,Georges Mikautadze,4,2024-2025,23,ge GEO,Lyon,fr Ligue 1,19,727,8.1,6,13,0,4,1,5,3,1,2,1,FW,4788cb6b,Rotational Player
1720,El Bilal Touré,4,2020-2021,18,ml MLI,Reims,fr Ligue 1,33,1245,13.8,11,22,3,4,1,5,4,0,0,0,FW,47c609d5,Rotational Player
1721,Denzel Dumfries,4,2023-2024,27,nl NED,Inter,it Serie A,31,1639,18.2,19,12,3,4,4,8,4,0,0,0,DF,481c9ece,Rotational Player
1722,Lucas Beltrán,4,2024-2025,23,ar ARG,Fiorentina,it Serie A,17,1017,11.3,11,6,4,4,4,8,2,2,2,0,MFFW,482d2bc3,Rotational Player
1723,Ruslan Malinovskyi,4,2023-2024,30,ua UKR,Genoa,it Serie A,28,1544,17.2,18,10,2,4,1,5,4,0,0,0,MF,48d5bd33,Rotational Player
1724,Joshua Kimmich,4,2020-2021,25,de GER,Bayern Munich,de Bundesliga,27,2194,24.4,25,2,0,4,10,14,4,0,0,0,MF,49296448,Full Starter
1725,Dani Carvajal,4,2023-2024,31,es ESP,Real Madrid,es La Liga,28,2171,24.1,25,3,5,4,3,7,4,0,0,0,DF,4958bfb2,Rotational Player
1726,Isaac Palazón Camacho,4,2023-2024,28,es ESP,Rayo Vallecano,es La Liga,37,2791,31.0,34,3,0,4,1,5,2,2,2,0,MFFW,49dbab27,Full Starter
1727,Timo Werner,4,2023-2024,27,de GER,2 Teams,2 Comps,21,1016,11.3,12,9,4,4,3,7,3,1,1,0,FWMF,49fe9070,Rotational Player
1728,Timo Werner,4,2021-2022,25,de GER,Chelsea,eng Premier League,21,1283,14.3,15,6,7,4,1,5,4,0,0,0,FWMF,49fe9070,Rotational Player
1729,Luis Díaz,4,2022-2023,25,co COL,Liverpool,eng Premier League,17,996,11.1,11,6,0,4,2,6,4,0,0,0,FW,4a1a9578,Rotational Player
1730,Luis Díaz,4,2021-2022,24,co COL,Liverpool,eng Premier League,13,958,10.6,11,2,3,4,3,7,4,0,0,0,FW,4a1a9578,Rotational Player
1731,Jordan Veretout,4,2021-2022,28,fr FRA,Roma,it Serie A,36,2319,25.8,26,10,0,4,8,12,3,1,2,1,MF,4a56052c,Full Starter
1732,Jordan Veretout,4,2022-2023,29,fr FRA,Marseille,fr Ligue 1,38,2863,31.8,31,7,0,4,3,7,3,1,1,0,MF,4a56052c,Full Starter
1733,Lorenzo Pellegrini,4,2022-2023,26,it ITA,Roma,it Serie A,32,2545,28.3,29,3,3,4,5,9,2,2,3,1,MF,4a5a45c7,Full Starter
1734,Adrian Grbić,4,2020-2021,23,at AUT,Lorient,fr Ligue 1,33,961,10.7,9,24,5,4,0,4,1,3,3,0,FW,4a987ffa,Bench Player
1735,Carlos Alcaraz,4,2022-2023,19,ar ARG,Southampton,eng Premier League,18,1029,11.4,13,5,2,4,2,6,4,0,0,0,MFFW,4abac767,Rotational Player
1736,Amir Rrahmani,4,2021-2022,27,xk KVX,Napoli,it Serie A,33,2927,32.5,33,0,4,4,0,4,4,0,0,0,DF,4b3e1a38,Full Starter
1737,Justin Kluivert,4,2021-2022,22,nl NED,Nice,fr Ligue 1,27,1868,20.8,24,3,1,4,5,9,4,0,0,0,MF,4c3a6744,Rotational Player
1738,Enrico Del Prato,4,2024-2025,24,it ITA,Parma,it Serie A,20,1687,18.7,18,2,0,4,0,4,4,0,0,0,DF,4c6f9258,Rotational Player
1739,Djibril Sow,4,2022-2023,25,ch SUI,Eint Frankfurt,de Bundesliga,32,2646,29.4,30,2,1,4,0,4,4,0,0,0,MF,4c6facae,Full Starter
1740,Brecht Dejaegere,4,2022-2023,31,be BEL,Toulouse,fr Ligue 1,30,1809,20.1,25,5,3,4,1,5,4,0,0,0,MF,4ca4f601,Rotational Player
1741,Sergio Agüero,4,2020-2021,32,ar ARG,Manchester City,eng Premier League,12,559,6.2,7,5,7,4,1,5,3,1,2,1,FW,4d034881,Bench Player
1742,Casemiro,4,2022-2023,30,br BRA,2 Teams,2 Comps,29,2132,23.7,24,5,0,4,3,7,4,0,0,0,MF,4d224fe8,Full Starter
1743,Darwin Núñez,4,2024-2025,25,uy URU,Liverpool,eng Premier League,17,804,8.9,7,10,3,4,2,6,4,0,0,0,FW,4d77b365,Rotational Player
1744,Luka Jović,4,2020-2021,22,rs SRB,2 Teams,2 Comps,22,1043,11.6,10,12,9,4,1,5,4,0,0,0,FW,4d8cd038,Rotational Player
1745,Thomas Lemar,4,2021-2022,25,fr FRA,Atlético Madrid,es La Liga,24,1440,16.0,17,7,0,4,5,9,4,0,0,0,MF,4dbd0916,Rotational Player
1746,Szymon Żurkowski,4,2023-2024,25,pl POL,Empoli,it Serie A,13,868,9.6,10,3,5,4,0,4,4,0,0,0,MF,4e1d5e59,Rotational Player
1747,Jacob Bruun Larsen,4,2021-2022,22,dk DEN,Hoffenheim,de Bundesliga,25,812,9.0,9,16,2,4,0,4,4,0,0,0,FWMF,4e204552,Rotational Player
1748,Yoann Touzghar,4,2021-2022,34,tn TUN,Troyes,fr Ligue 1,28,1457,16.2,16,12,1,4,0,4,4,0,0,0,FW,4e47507a,Rotational Player
1749,Thorgan Hazard,4,2021-2022,28,be BEL,Dortmund,de Bundesliga,23,1337,14.9,14,9,0,4,1,5,4,0,0,0,FWDF,50871bcc,Rotational Player
1750,Darko Lazović,4,2022-2023,31,rs SRB,Hellas Verona,it Serie A,30,2242,24.9,27,3,0,4,5,9,4,0,0,0,MFDF,5128bde4,Full Starter
1751,Kevin Schade,4,2021-2022,19,de GER,Freiburg,de Bundesliga,21,831,9.2,7,14,3,4,1,5,4,0,0,0,MFFW,52afb588,Bench Player
1752,Paulinho,4,2021-2022,21,br BRA,Leverkusen,de Bundesliga,24,1218,13.5,14,10,8,4,1,5,4,0,0,0,FWMF,53070b63,Rotational Player
1753,Yeremi Pino,4,2022-2023,19,es ESP,Villarreal,es La Liga,36,2447,27.2,31,5,1,4,6,10,4,0,0,0,FWMF,540ec57b,Rotational Player
1754,Kerem Demirbay,4,2020-2021,27,de GER,Leverkusen,de Bundesliga,29,1744,19.4,20,9,3,4,3,7,4,0,0,0,MF,54b4dc4e,Rotational Player
1755,Kerem Demirbay,4,2022-2023,29,de GER,Leverkusen,de Bundesliga,25,1544,17.2,17,8,7,4,3,7,4,0,0,0,MF,54b4dc4e,Rotational Player
1756,Nadiem Amiri,4,2024-2025,27,de GER,Mainz 05,de Bundesliga,16,1285,14.3,16,0,0,4,2,6,2,2,2,0,MF,555d5edd,Rotational Player
1757,Nadiem Amiri,4,2022-2023,25,de GER,Leverkusen,de Bundesliga,25,977,10.9,9,16,4,4,1,5,3,1,1,0,MFFW,555d5edd,Rotational Player
1758,Tommaso Pobega,4,2021-2022,22,it ITA,2 Teams,it Serie A,33,2240,24.9,24,9,2,4,2,6,4,0,0,0,MF,55a1cac2,Rotational Player
1759,Asier Villalibre,4,2020-2021,22,es ESP,Athletic Club,es La Liga,35,1589,17.7,16,19,1,4,2,6,4,0,0,0,FW,57be54ec,Rotational Player
1760,Dimitri Payet,4,2022-2023,35,fr FRA,Marseille,fr Ligue 1,24,835,9.3,9,15,8,4,3,7,3,1,1,0,MFFW,58ae47b2,Rotational Player
1761,Christian Kouamé,4,2022-2023,24,ci CIV,Fiorentina,it Serie A,28,1866,20.7,22,6,10,4,4,8,4,0,0,0,FW,58e933d2,Rotational Player
1762,David Costa,4,2023-2024,22,pt POR,Lens,fr Ligue 1,25,1494,16.6,17,8,2,4,2,6,4,0,0,0,MF,59948ef7,Rotational Player
1763,Moi Gómez,4,2020-2021,26,es ESP,Villarreal,es La Liga,35,2563,28.5,29,6,0,4,0,4,3,1,1,0,MFFW,5a626448,Full Starter
1764,Gianluca Mancini,4,2020-2021,24,it ITA,Roma,it Serie A,33,2852,31.7,33,0,1,4,2,6,4,0,0,0,DF,5aa53281,Full Starter
1765,Gianluca Mancini,4,2023-2024,27,it ITA,Roma,it Serie A,36,2869,31.9,34,2,1,4,1,5,4,0,0,0,DF,5aa53281,Full Starter
1766,Joško Gvardiol,4,2023-2024,21,hr CRO,Manchester City,eng Premier League,28,2328,25.9,26,2,7,4,1,5,4,0,0,0,DF,5ad50391,Rotational Player
1767,Josan,4,2020-2021,30,es ESP,Elche,es La Liga,33,1926,21.4,24,9,3,4,2,6,4,0,0,0,MFDF,5b28b2f6,Rotational Player
1768,Myron Boadu,4,2021-2022,20,nl NED,Monaco,fr Ligue 1,31,960,10.7,7,24,1,4,1,5,4,0,0,0,FW,5b479568,Bench Player
1769,Hugo Ekitike,4,2023-2024,21,fr FRA,2 Teams,2 Comps,15,725,8.1,7,8,2,4,2,6,4,0,0,0,FW,5b92d896,Rotational Player
1770,Miloš Pantović,4,2021-2022,25,rs SRB,Bochum,de Bundesliga,28,1533,17.0,18,10,4,4,3,7,3,1,1,0,MFFW,5dc15574,Rotational Player
1771,Irvin Cardona,4,2021-2022,23,fr FRA,Brest,fr Ligue 1,32,1334,14.8,13,19,3,4,2,6,4,0,0,0,FWMF,5e080f73,Rotational Player
1772,Franco Cervi,4,2021-2022,27,ar ARG,Celta Vigo,es La Liga,33,1801,20.0,21,12,2,4,3,7,4,0,0,0,MF,5e1028e5,Rotational Player
1773,Mattéo Guendouzi,4,2021-2022,22,fr FRA,Marseille,fr Ligue 1,38,3152,35.0,35,3,0,4,6,10,4,0,0,0,MF,5ea8ef20,Full Starter
1774,Kenedy,4,2020-2021,24,br BRA,Granada,es La Liga,28,1471,16.3,18,10,2,4,3,7,4,0,0,0,FWMF,5eebbfdf,Rotational Player
1775,John Stones,4,2020-2021,26,eng ENG,Manchester City,eng Premier League,22,1933,21.5,22,0,12,4,0,4,4,0,0,0,DF,5eecec3d,Rotational Player
1776,Charalambos Lykogiannis,4,2020-2021,26,gr GRE,Cagliari,it Serie A,31,2418,26.9,29,2,2,4,2,6,4,0,0,0,DF,5efc5389,Full Starter
1777,Gleison Bremer,4,2022-2023,25,br BRA,Juventus,it Serie A,30,2634,29.3,30,0,3,4,1,5,4,0,0,0,DF,5fd5ed86,Full Starter
1778,Stefano Okaka,4,2020-2021,30,it ITA,Udinese,it Serie A,22,1489,16.5,17,5,4,4,1,5,4,0,0,0,FW,601ef102,Rotational Player
1779,Luka Modrić,4,2022-2023,36,hr CRO,Real Madrid,es La Liga,33,1744,19.4,19,14,1,4,3,7,3,1,1,0,MF,6025fab1,Full Starter
1780,Josh Dasilva,4,2022-2023,23,eng ENG,Brentford,eng Premier League,36,1389,15.4,14,22,2,4,2,6,4,0,0,0,MF,60344e4f,Rotational Player
1781,Jeong Woo-yeong,4,2020-2021,20,kr KOR,Freiburg,de Bundesliga,26,823,9.1,7,19,7,4,0,4,4,0,0,0,FWMF,6190474d,Rotational Player
1782,Ludovic Blas,4,2023-2024,25,fr FRA,Rennes,fr Ligue 1,29,1563,17.4,18,11,3,4,1,5,3,1,2,1,FWMF,6191093d,Full Starter
1783,Ignacio Pussetto,4,2021-2022,25,ar ARG,Udinese,it Serie A,28,1204,13.4,11,17,7,4,4,8,3,1,1,0,FWMF,62437b4f,Rotational Player
1784,Alfonso Pedraza,4,2021-2022,25,es ESP,Villarreal,es La Liga,28,1701,18.9,19,9,9,4,4,8,4,0,0,0,DF,63f04c6c,Rotational Player
1785,Ange-Yoan Bonny,4,2024-2025,20,fr FRA,Parma,it Serie A,21,1388,15.4,17,4,0,4,1,5,3,1,2,1,FW,64629ba4,Rotational Player
1786,Andrea Colpani,4,2022-2023,23,it ITA,Monza,it Serie A,27,948,10.5,10,17,8,4,1,5,4,0,0,0,MF,6499048c,Rotational Player
1787,Rodrigo Riquelme,4,2022-2023,22,es ESP,Girona,es La Liga,34,2179,24.2,25,9,1,4,4,8,4,0,0,0,MFFW,65154df0,Rotational Player
1788,Hakim Ziyech,4,2021-2022,28,ma MAR,Chelsea,eng Premier League,23,1319,14.7,14,9,13,4,3,7,4,0,0,0,MFFW,6622454d,Rotational Player
1789,Andreas Pereira,4,2022-2023,26,br BRA,Fulham,eng Premier League,33,2692,29.9,33,0,0,4,6,10,3,1,1,0,MF,6639e500,Full Starter
1790,Emi Buendía,4,2021-2022,24,ar ARG,Aston Villa,eng Premier League,35,1899,21.1,22,13,2,4,6,10,4,0,0,0,MFFW,66b76d44,Rotational Player
1791,Gabriel Magalhães,4,2023-2024,25,br BRA,Arsenal,eng Premier League,36,3044,33.8,34,2,2,4,0,4,4,0,0,0,DF,67ac5bb8,Full Starter
1792,Gonzalo Castro,4,2020-2021,33,de GER,Stuttgart,de Bundesliga,26,1729,19.2,23,3,3,4,2,6,4,0,0,0,MF,68829001,Rotational Player
1793,Mohamed Elyounoussi,4,2021-2022,26,no NOR,Southampton,eng Premier League,30,2042,22.7,23,7,5,4,2,6,4,0,0,0,MFFW,68dc0dac,Rotational Player
1794,Iñaki Williams,4,2024-2025,30,gh GHA,Athletic Club,es La Liga,20,1645,18.3,19,1,0,4,6,10,4,0,0,0,FW,6a99e0b1,Full Starter
1795,Bryan Mbeumo,4,2021-2022,21,cm CMR,Brentford,eng Premier League,35,2905,32.3,34,1,1,4,7,11,3,1,1,0,FW,6afaebf2,Full Starter
1796,Habib Diarra,4,2024-2025,20,sn SEN,Strasbourg,fr Ligue 1,18,1550,17.2,18,0,0,4,3,7,2,2,2,0,MFFW,6d0fe035,Rotational Player
1797,Florian Lejeune,4,2022-2023,31,fr FRA,Rayo Vallecano,es La Liga,31,2565,28.5,31,0,4,4,0,4,4,0,0,0,DF,6eaed4eb,Full Starter
1798,Ruben Vargas,4,2023-2024,24,ch SUI,Augsburg,de Bundesliga,31,1962,21.8,25,6,0,4,5,9,4,0,0,0,MFFW,6ecbddf6,Rotational Player
1799,Hugo Álvarez,4,2024-2025,21,es ESP,Celta Vigo,es La Liga,20,1281,14.2,13,7,0,4,1,5,4,0,0,0,MFDF,6f392eb8,Rotational Player
1800,Ivan Perišić,4,2020-2021,31,hr CRO,Inter,it Serie A,32,1795,19.9,20,12,4,4,3,7,4,0,0,0,DFFW,6fe90922,Full Starter
1801,Idrissa Gana Gueye,4,2023-2024,33,sn SEN,Everton,eng Premier League,25,1884,20.9,24,1,3,4,0,4,4,0,0,0,MF,72c812f3,Rotational Player
1802,Alexis Claude-Maurice,4,2020-2021,22,fr FRA,Nice,fr Ligue 1,30,1910,21.2,21,9,3,4,5,9,4,0,0,0,MFFW,741418c3,Rotational Player
1803,Vagner Gonçalves,4,2020-2021,24,cv CPV,Metz,fr Ligue 1,26,967,10.7,10,16,4,4,1,5,2,2,2,0,FWMF,743fd71f,Rotational Player
1804,Jens Odgaard,4,2024-2025,25,dk DEN,Bologna,it Serie A,19,1269,14.1,16,3,2,4,0,4,4,0,0,0,MFFW,75374ee7,Rotational Player
1805,Roberto Pereyra,4,2023-2024,32,ar ARG,Udinese,it Serie A,27,1858,20.6,22,5,4,4,3,7,3,1,1,0,FWMF,75f2c59f,Full Starter
1806,Chiedozie Ogbene,4,2023-2024,26,ie IRL,Luton Town,eng Premier League,30,1995,22.2,20,10,0,4,1,5,4,0,0,0,MFDF,788c0277,Rotational Player
1807,Himad Abdelli,4,2024-2025,24,dz ALG,Angers,fr Ligue 1,19,1682,18.7,19,0,0,4,1,5,2,2,3,1,MFFW,7978cbf0,Rotational Player
1808,Mateo Kovačić,4,2024-2025,30,hr CRO,Manchester City,eng Premier League,19,1455,16.2,17,2,0,4,1,5,4,0,0,0,MF,79c0821a,Rotational Player
1809,Caleb Ekuban,4,2023-2024,29,gh GHA,Genoa,it Serie A,29,1131,12.6,10,19,2,4,1,5,4,0,0,0,FW,7afbd2c3,Rotational Player
1810,Bryan Gil,4,2020-2021,19,es ESP,2 Teams,es La Liga,29,2278,25.3,26,3,1,4,3,7,4,0,0,0,FW,7b5ab7f2,Rotational Player
1811,Arnaud Nordin,4,2020-2021,22,fr FRA,Saint-Étienne,fr Ligue 1,32,1771,19.7,20,12,0,4,4,8,4,0,0,0,MFFW,7b9a9e25,Rotational Player
1812,Arnaud Nordin,4,2021-2022,23,fr FRA,Saint-Étienne,fr Ligue 1,36,1874,20.8,20,16,0,4,4,8,4,0,0,0,FWMF,7b9a9e25,Rotational Player
1813,Arnaud Nordin,4,2024-2025,26,fr FRA,Montpellier,fr Ligue 1,16,1166,13.0,14,2,0,4,1,5,3,1,2,1,FW,7b9a9e25,Rotational Player
1814,Ademola Lookman,4,2020-2021,22,ng NGA,2 Teams,2 Comps,34,2747,30.5,31,3,1,4,4,8,4,0,1,1,FWMF,7c104bb7,Rotational Player
1815,Lars Stindl,4,2021-2022,32,de GER,Gladbach,de Bundesliga,26,1629,18.1,20,6,1,4,5,9,4,0,2,2,MFFW,7cd6badb,Rotational Player
1816,Khéphren Thuram,4,2021-2022,20,fr FRA,Nice,fr Ligue 1,36,1901,21.1,20,16,1,4,2,6,4,0,0,0,MF,7d9397f8,Rotational Player
1817,Florent Mollet,4,2023-2024,31,fr FRA,Nantes,fr Ligue 1,29,2083,23.1,24,5,2,4,4,8,4,0,0,0,MFFW,7e82a78f,Full Starter
1818,Nicola Sansone,4,2022-2023,30,it ITA,Bologna,it Serie A,18,740,8.2,8,10,8,4,2,6,4,0,0,0,FW,7eb97a8e,Bench Player
1819,Gastón Pereiro,4,2021-2022,26,uy URU,Cagliari,it Serie A,29,975,10.8,9,20,9,4,2,6,4,0,0,0,FWMF,7ec7738e,Bench Player
1820,Fikayo Tomori,4,2023-2024,25,eng ENG,Milan,it Serie A,26,2121,23.6,24,2,1,4,0,4,4,0,0,0,DF,7edfbb8a,Rotational Player
1821,Alessandro Deiola,4,2021-2022,25,it ITA,Cagliari,it Serie A,33,2129,23.7,28,5,3,4,1,5,4,0,0,0,MF,7f267d66,Full Starter
1822,Gio Reyna,4,2020-2021,17,us USA,Dortmund,de Bundesliga,32,1976,22.0,23,9,0,4,5,9,4,0,0,0,MFFW,7fa4e703,Rotational Player
1823,Davide Zappacosta,4,2022-2023,30,it ITA,Atalanta,it Serie A,21,1471,16.3,18,3,1,4,2,6,4,0,0,0,DF,7fe90ccd,Rotational Player
1824,Davide Zappacosta,4,2020-2021,28,it ITA,Genoa,it Serie A,25,2045,22.7,23,2,2,4,2,6,4,0,0,0,DF,7fe90ccd,Rotational Player
1825,Daniel Maldini,4,2023-2024,21,it ITA,2 Teams,it Serie A,18,596,6.6,5,13,8,4,1,5,4,0,0,0,MFFW,801831fe,Rotational Player
1826,Toma Bašić,4,2020-2021,23,hr CRO,Bordeaux,fr Ligue 1,34,2601,28.9,32,2,1,4,1,5,4,0,0,0,MF,80556f08,Full Starter
1827,Dominick Drexler,4,2022-2023,32,de GER,Schalke 04,de Bundesliga,27,1366,15.2,16,11,0,4,3,7,4,0,0,0,MFFW,809940aa,Rotational Player
1828,Krépin Diatta,4,2022-2023,23,sn SEN,Monaco,fr Ligue 1,31,2072,23.0,22,9,3,4,2,6,4,0,0,0,MFFW,8104e41e,Rotational Player
1829,Youssouf Fofana,4,2023-2024,24,fr FRA,Monaco,fr Ligue 1,32,2697,30.0,31,1,0,4,4,8,4,0,0,0,MF,822d51d7,Full Starter
1830,Bruno Guimarães,4,2022-2023,24,br BRA,Newcastle Utd,eng Premier League,32,2726,30.3,32,0,0,4,5,9,4,0,0,0,MF,82518f62,Full Starter
1831,Juanmi,4,2022-2023,29,es ESP,Betis,es La Liga,22,925,10.3,9,13,3,4,0,4,4,0,0,0,FW,84399660,Rotational Player
1832,Vitaly Janelt,4,2021-2022,23,de GER,Brentford,eng Premier League,31,2298,25.5,27,4,1,4,0,4,4,0,0,0,MF,8449d35e,Full Starter
1833,Arkadiusz Milik,4,2023-2024,29,pl POL,Juventus,it Serie A,32,919,10.2,7,25,0,4,1,5,4,0,0,0,FW,85613cf0,Rotational Player
1834,Miguel Almirón,4,2020-2021,26,py PAR,Newcastle Utd,eng Premier League,34,2429,27.0,28,6,2,4,1,5,4,0,0,0,MFFW,862a1c15,Full Starter
1835,Martin Satriano,4,2021-2022,20,uy URU,2 Teams,2 Comps,19,970,10.8,11,8,9,4,0,4,4,0,0,0,FWMF,86383d0e,Rotational Player
1836,Martin Satriano,4,2023-2024,22,uy URU,Brest,fr Ligue 1,33,1864,20.7,21,12,0,4,4,8,4,0,0,0,FW,86383d0e,Rotational Player
1837,Johan Gastien,4,2022-2023,34,fr FRA,Clermont Foot,fr Ligue 1,31,2603,28.9,29,2,0,4,3,7,4,0,0,0,MF,868eaba0,Full Starter
1838,Munir El Haddadi,4,2020-2021,24,ma MAR,Sevilla,es La Liga,24,845,9.4,9,15,10,4,2,6,4,0,0,0,FW,8696bc90,Rotational Player
1839,Maximilian Arnold,4,2021-2022,27,de GER,Wolfsburg,de Bundesliga,34,2994,33.3,34,0,0,4,2,6,4,0,0,0,MF,86e119e0,Full Starter
1840,Philipp Hofmann,4,2023-2024,30,de GER,Bochum,de Bundesliga,29,1571,17.5,18,11,2,4,2,6,4,0,0,0,FW,877bc844,Rotational Player
1841,Adrien Rabiot,4,2020-2021,25,fr FRA,Juventus,it Serie A,34,2313,25.7,25,9,1,4,2,6,4,0,0,0,MF,8794e251,Full Starter
1842,Mathias Pereira Lage,4,2020-2021,23,pt POR,Angers,fr Ligue 1,28,1467,16.3,16,12,1,4,1,5,4,0,0,0,FWMF,8846a40f,Rotational Player
1843,Mathias Pereira Lage,4,2021-2022,24,pt POR,Angers,fr Ligue 1,24,1040,11.6,11,13,9,4,2,6,4,0,0,0,DF,8846a40f,Rotational Player
1844,Manor Solomon,4,2022-2023,23,il ISR,Fulham,eng Premier League,19,572,6.4,4,15,3,4,0,4,4,0,0,0,FW,886f9aac,Bench Player
1845,Jérémy Le Douaron,4,2023-2024,25,fr FRA,Brest,fr Ligue 1,33,1618,18.0,19,14,0,4,0,4,4,0,0,0,FW,88c4d190,Rotational Player
1846,Ivan Rakitić,4,2020-2021,32,hr CRO,Sevilla,es La Liga,37,2233,24.8,25,12,0,4,2,6,2,2,2,0,MF,89f951b5,Full Starter
1847,Ivan Rakitić,4,2021-2022,33,hr CRO,Sevilla,es La Liga,35,2182,24.2,26,9,1,4,6,10,3,1,2,1,MF,89f951b5,Full Starter
1848,Pascal Groß,4,2023-2024,32,de GER,Brighton,eng Premier League,36,3114,34.6,34,2,0,4,10,14,3,1,1,0,MFDF,8aec0537,Full Starter
1849,Pierre Højbjerg,4,2022-2023,26,dk DEN,Tottenham,eng Premier League,35,3131,34.8,35,0,0,4,5,9,4,0,0,0,MF,8b04d6c1,Full Starter
1850,Clément Grenier,4,2020-2021,29,fr FRA,Rennes,fr Ligue 1,23,1078,12.0,12,11,4,4,3,7,3,1,1,0,MFFW,8b298f56,Rotational Player
1851,Yann Karamoh,4,2022-2023,24,fr FRA,Torino,it Serie A,21,716,8.0,7,14,9,4,0,4,4,0,0,0,MFFW,8b66d9cc,Bench Player
1852,Anthony Martial,4,2020-2021,24,fr FRA,Manchester Utd,eng Premier League,22,1480,16.4,17,5,1,4,3,7,4,0,0,0,FW,8b788c01,Rotational Player
1853,Willian,4,2023-2024,34,br BRA,Fulham,eng Premier League,31,2053,22.8,24,7,2,4,2,6,2,2,2,0,FW,8b9ebd03,Rotational Player
1854,Mikel Oyarzabal,4,2024-2025,27,es ESP,Real Sociedad,es La Liga,19,1268,14.1,17,2,1,4,2,6,2,2,2,0,FW,8c3c640c,Rotational Player
1855,Mikel Oyarzabal,4,2022-2023,25,es ESP,Real Sociedad,es La Liga,23,1214,13.5,14,9,1,4,1,5,2,2,3,1,FWMF,8c3c640c,Rotational Player
1856,Ángel Rodríguez,4,2021-2022,34,es ESP,Mallorca,es La Liga,29,1544,17.2,19,10,4,4,2,6,4,0,0,0,FWMF,8cfc2f69,Rotational Player
1857,Adrien Tameze,4,2021-2022,27,cm CMR,Hellas Verona,it Serie A,38,2574,28.6,26,12,0,4,2,6,4,0,0,0,MFDF,8da74c05,Full Starter
1858,Sheraldo Becker,4,2021-2022,26,sr SUR,Union Berlin,de Bundesliga,28,1758,19.5,22,6,3,4,6,10,4,0,0,0,FWMF,8eb55dbb,Rotational Player
1859,Rodrygo,4,2021-2022,20,br BRA,Real Madrid,es La Liga,33,1523,16.9,17,16,1,4,4,8,4,0,0,0,FW,8f5e92a6,Rotational Player
1860,Grischa Prömel,4,2023-2024,28,de GER,Hoffenheim,de Bundesliga,28,2139,23.8,27,1,0,4,5,9,4,0,0,0,MF,924f9191,Full Starter
1861,Mattias Svanberg,4,2022-2023,23,se SWE,Wolfsburg,de Bundesliga,32,1835,20.4,21,11,1,4,6,10,4,0,0,0,MFFW,92d83c27,Full Starter
1862,Patrick Bamford,4,2022-2023,28,eng ENG,Leeds United,eng Premier League,28,1515,16.8,18,10,0,4,2,6,4,0,2,2,FW,93feac6e,Full Starter
1863,Florian Kainz,4,2021-2022,28,at AUT,Köln,de Bundesliga,32,2320,25.8,31,1,0,4,4,8,4,0,0,0,MFFW,94c18565,Full Starter
1864,Giulio Maggiore,4,2023-2024,25,it ITA,Salernitana,it Serie A,27,1800,20.0,20,7,3,4,2,6,4,0,0,0,MF,957e4c87,Rotational Player
1865,Federico Dimarco,4,2022-2023,24,it ITA,Inter,it Serie A,33,2069,23.0,26,7,1,4,3,7,4,0,0,0,DF,970b8574,Full Starter
1866,Stuart Armstrong,4,2020-2021,28,sct SCO,Southampton,eng Premier League,33,2764,30.7,32,1,1,4,5,9,4,0,0,0,MF,97333cf5,Full Starter
1867,Pablo Sarabia,4,2023-2024,31,es ESP,Wolves,eng Premier League,30,1745,19.4,20,10,7,4,7,11,2,2,2,0,MFFW,9744ff80,Rotational Player
1868,Antony,4,2022-2023,22,br BRA,Manchester Utd,eng Premier League,25,1802,20.0,23,2,0,4,2,6,4,0,0,0,FW,99127249,Rotational Player
1869,Lucas Paquetá,4,2022-2023,24,br BRA,2 Teams,2 Comps,30,2310,25.7,29,1,1,4,3,7,3,1,1,0,MF,9b6f7fd5,Full Starter
1870,Lucas Paquetá,4,2023-2024,25,br BRA,West Ham,eng Premier League,31,2622,29.1,31,0,0,4,6,10,2,2,2,0,FWMF,9b6f7fd5,Full Starter
1871,Lucas Paquetá,4,2024-2025,26,br BRA,West Ham,eng Premier League,22,1609,17.9,19,3,0,4,0,4,2,2,2,0,MFFW,9b6f7fd5,Full Starter
1872,Wout Faes,4,2021-2022,23,be BEL,Reims,fr Ligue 1,37,3330,37.0,37,0,0,4,0,4,4,0,0,0,DF,9c221d14,Full Starter
1873,Julio Enciso,4,2022-2023,18,py PAR,Brighton,eng Premier League,20,806,9.0,7,13,11,4,2,6,4,0,0,0,FWMF,9cfbad36,Bench Player
1874,Alexandre Lacazette,4,2021-2022,30,fr FRA,Arsenal,eng Premier League,30,1782,19.8,20,10,5,4,7,11,2,2,3,1,FW,9dbb75ca,Rotational Player
1875,Ferrán Torres,4,2022-2023,22,es ESP,Barcelona,es La Liga,33,1392,15.5,14,19,3,4,2,6,4,0,1,1,FWMF,9e1035f8,Rotational Player
1876,Ferrán Torres,4,2024-2025,24,es ESP,Barcelona,es La Liga,15,617,6.9,7,8,0,4,2,6,4,0,0,0,FWMF,9e1035f8,Rotational Player
1877,Cristiano Biraghi,4,2021-2022,28,it ITA,Fiorentina,it Serie A,37,3153,35.0,37,0,0,4,1,5,3,1,2,1,DF,9e1577aa,Full Starter
1878,Désiré Doué,4,2023-2024,18,fr FRA,Rennes,fr Ligue 1,31,1626,18.1,17,14,1,4,4,8,4,0,0,0,MFFW,9e7483ff,Rotational Player
1879,Farid Boulaya,4,2021-2022,28,dz ALG,Metz,fr Ligue 1,24,1526,17.0,18,6,4,4,2,6,4,0,0,0,MFFW,a0791826,Rotational Player
1880,Lucas Ocampos,4,2023-2024,29,ar ARG,Sevilla,es La Liga,35,2871,31.9,34,1,1,4,3,7,3,1,1,0,FWMF,a08b974a,Rotational Player
1881,Lucas Ocampos,4,2022-2023,28,ar ARG,Sevilla,es La Liga,19,1165,12.9,11,8,3,4,0,4,1,3,3,0,FWMF,a08b974a,Rotational Player
1882,Bradley Barcola,4,2023-2024,20,fr FRA,2 Teams,fr Ligue 1,28,1640,18.2,21,7,2,4,7,11,4,0,0,0,FW,a0d55a09,Rotational Player
1883,Marcus Rashford,4,2024-2025,26,eng ENG,Manchester Utd,eng Premier League,15,978,10.9,12,3,1,4,1,5,4,0,0,0,FWMF,a1d5bd30,Rotational Player
1884,Marcus Rashford,4,2021-2022,23,eng ENG,Manchester Utd,eng Premier League,25,1235,13.7,13,12,3,4,2,6,4,0,0,0,FWMF,a1d5bd30,Rotational Player
1885,Teun Koopmeiners,4,2021-2022,23,nl NED,Atalanta,it Serie A,30,2126,23.6,23,7,4,4,1,5,4,0,0,0,MF,a26fb8aa,Full Starter
1886,Matheus Henrique,4,2022-2023,24,br BRA,Sassuolo,it Serie A,30,1947,21.6,21,9,8,4,1,5,4,0,0,0,MF,a2d9f138,Rotational Player
1887,Lucas Pérez,4,2020-2021,31,es ESP,Alavés,es La Liga,28,1759,19.5,19,9,4,4,4,8,1,3,4,1,FW,a300ac7e,Rotational Player
1888,Erhan Mašović,4,2022-2023,23,rs SRB,Bochum,de Bundesliga,29,2178,24.2,23,6,1,4,0,4,4,0,0,0,DFMF,a396fb61,Rotational Player
1889,Loum Tchaouna,4,2023-2024,19,fr FRA,Salernitana,it Serie A,33,2100,23.3,23,10,2,4,3,7,4,0,0,0,FWMF,a3c8b4d3,Rotational Player
1890,Eddie Nketiah,4,2022-2023,23,eng ENG,Arsenal,eng Premier League,30,1089,12.1,9,21,3,4,1,5,4,0,0,0,FW,a53649b7,Bench Player
1891,Houssem Aouar,4,2023-2024,25,dz ALG,Roma,it Serie A,16,756,8.4,9,7,14,4,0,4,4,0,0,0,MFFW,a5db0bec,Rotational Player
1892,Kamaldeen Sulemana,4,2021-2022,19,gh GHA,Rennes,fr Ligue 1,20,1015,11.3,11,9,1,4,2,6,4,0,0,0,MFFW,a62f8bf1,Rotational Player
1893,Sergio Canales,4,2022-2023,31,es ESP,Betis,es La Liga,31,2402,26.7,28,3,0,4,3,7,3,1,1,0,FWMF,a6de370d,Full Starter
1894,João Palhinha,4,2023-2024,28,pt POR,Fulham,eng Premier League,33,2699,30.0,31,2,0,4,1,5,4,0,0,0,MF,a78ff07f,Full Starter
1895,Manuel Locatelli,4,2020-2021,22,it ITA,Sassuolo,it Serie A,34,2883,32.0,32,2,0,4,2,6,2,2,2,0,MF,a8a874f1,Full Starter
1896,Pierre-Yves Hamel,4,2020-2021,26,fr FRA,Lorient,fr Ligue 1,23,849,9.4,7,16,11,4,2,6,3,1,1,0,FW,a99da9ec,Bench Player
1897,Aleksei Miranchuk,4,2022-2023,26,ru RUS,Torino,it Serie A,29,2089,23.2,24,5,1,4,5,9,4,0,0,0,MF,a9aa0d1d,Rotational Player
1898,Aleksei Miranchuk,4,2020-2021,24,ru RUS,Atalanta,it Serie A,25,675,7.5,4,21,8,4,2,6,4,0,0,0,MFFW,a9aa0d1d,Rotational Player
1899,Álex Fernández,4,2020-2021,27,es ESP,Cádiz,es La Liga,25,1946,21.6,21,4,0,4,1,5,2,2,2,0,MF,aa677a35,Rotational Player
1900,Davide Faraoni,4,2021-2022,29,it ITA,Hellas Verona,it Serie A,32,2572,28.6,30,2,0,4,5,9,4,0,0,0,DF,aae9d04a,Full Starter
1901,Davide Faraoni,4,2020-2021,28,it ITA,Hellas Verona,it Serie A,34,2891,32.1,33,1,0,4,7,11,4,0,0,0,DF,aae9d04a,Full Starter
1902,Christian Benteke,4,2021-2022,30,be BEL,Crystal Palace,eng Premier League,25,1145,12.7,11,14,12,4,1,5,4,0,0,0,FW,ab070c55,Rotational Player
1903,Marius Bülter,4,2024-2025,31,de GER,Hoffenheim,de Bundesliga,12,813,9.0,11,1,0,4,1,5,4,0,0,0,FW,ab5b7dc1,Rotational Player
1904,Luuk de Jong,4,2020-2021,29,nl NED,Sevilla,es La Liga,34,1268,14.1,14,20,4,4,0,4,4,0,0,0,FW,abb3bb95,Rotational Player
1905,Dani Olmo,4,2023-2024,25,es ESP,RB Leipzig,de Bundesliga,21,1449,16.1,17,4,0,4,5,9,4,0,0,0,MF,ae44e8e2,Rotational Player
1906,Eberechi Eze,4,2020-2021,22,eng ENG,Crystal Palace,eng Premier League,34,2559,28.4,29,5,2,4,6,10,4,0,0,0,MF,ae4fc6a4,Full Starter
1907,Marcos André,4,2020-2021,23,br BRA,Valladolid,es La Liga,23,1177,13.1,11,12,0,4,1,5,4,0,0,0,FW,ae86d473,Rotational Player
1908,Brajan Gruda,4,2023-2024,19,de GER,Mainz 05,de Bundesliga,28,1641,18.2,19,9,1,4,3,7,4,0,0,0,MFFW,ae9b998d,Rotational Player
1909,Moussa Diaby,4,2020-2021,21,fr FRA,Leverkusen,de Bundesliga,32,2388,26.5,28,4,0,4,11,15,4,0,0,0,FWMF,aeed5c06,Full Starter
1910,Komnen Andrić,4,2022-2023,27,rs SRB,Clermont Foot,fr Ligue 1,34,1446,16.1,16,18,0,4,3,7,3,1,2,1,FW,af3ddb2e,Rotational Player
1911,Zito Luvumbo,4,2023-2024,21,ao ANG,Cagliari,it Serie A,30,1946,21.6,19,11,1,4,5,9,4,0,0,0,FWMF,b09e0873,Rotational Player
1912,Sofiane Boufal,4,2022-2023,28,ma MAR,Angers,fr Ligue 1,13,834,9.3,9,4,0,4,3,7,2,2,2,0,FWMF,b0c71810,Rotational Player
1913,Denis Huseinbasic,4,2022-2023,21,ba BIH,Köln,de Bundesliga,24,791,8.8,7,17,5,4,1,5,4,0,0,0,MFFW,b116c6e3,Bench Player
1914,Filip Kostić,4,2021-2022,28,rs SRB,Eint Frankfurt,de Bundesliga,31,2522,28.0,28,3,0,4,9,13,4,0,0,0,DFFW,b1cd37e6,Full Starter
1915,Filip Kostić,4,2020-2021,27,rs SRB,Eint Frankfurt,de Bundesliga,30,2534,28.2,29,1,0,4,14,18,4,0,0,0,DF,b1cd37e6,Full Starter
1916,Suat Serdar,4,2022-2023,25,de GER,Hertha BSC,de Bundesliga,32,2021,22.5,24,8,0,4,2,6,4,0,0,0,MF,b3325a30,Full Starter
1917,Rayan Cherki,4,2022-2023,18,fr FRA,Lyon,fr Ligue 1,34,1872,20.8,21,13,4,4,6,10,4,0,0,0,MFFW,b34c63a5,Rotational Player
1918,Nabil Alioui,4,2023-2024,24,fr FRA,Le Havre,fr Ligue 1,18,1009,11.2,12,6,1,4,1,5,4,0,0,0,MFFW,b386310a,Rotational Player
1919,Deiver Machado,4,2022-2023,28,co COL,Lens,fr Ligue 1,33,2184,24.3,26,7,2,4,3,7,4,0,0,0,DFMF,b3f8bdef,Rotational Player
1920,Deiver Machado,4,2023-2024,29,co COL,Lens,fr Ligue 1,19,1124,12.5,13,6,1,4,0,4,4,0,0,0,DF,b3f8bdef,Rotational Player
1921,Tiago Tomás,4,2021-2022,19,pt POR,Stuttgart,de Bundesliga,14,1075,11.9,13,1,0,4,0,4,4,0,0,0,FW,b492126a,Rotational Player
1922,Raúl Jiménez,4,2020-2021,29,mx MEX,Wolves,eng Premier League,10,823,9.1,10,0,0,4,0,4,4,0,0,0,FW,b561db50,Rotational Player
1923,Gabriel Jesus,4,2023-2024,26,br BRA,Arsenal,eng Premier League,27,1478,16.4,17,10,3,4,5,9,4,0,0,0,FW,b66315ae,Rotational Player
1924,Ismaël Traoré,4,2021-2022,34,ci CIV,Angers,fr Ligue 1,37,3215,35.7,36,1,0,4,1,5,4,0,0,0,DF,b666421b,Full Starter
1925,Jordan Pefok,4,2022-2023,26,us USA,Union Berlin,de Bundesliga,31,1358,15.1,16,15,2,4,4,8,4,0,2,2,FW,b684a484,Rotational Player
1926,Matteo Cancellieri,4,2023-2024,21,it ITA,Empoli,it Serie A,36,1788,19.9,18,18,0,4,3,7,4,0,0,0,FWMF,b6a1cdf9,Rotational Player
1927,Gabriel Paulista,4,2020-2021,29,br BRA,Valencia,es La Liga,31,2716,30.2,31,0,0,4,1,5,4,0,0,0,DF,b7ca5c51,Full Starter
1928,Fred,4,2021-2022,28,br BRA,Manchester Utd,eng Premier League,28,2028,22.5,24,4,3,4,4,8,4,0,0,0,MF,b853e0ad,Rotational Player
1929,Samuel Chukwueze,4,2020-2021,21,ng NGA,Villarreal,es La Liga,28,1365,15.2,13,15,1,4,2,6,4,0,0,0,MFFW,b8a642fc,Rotational Player
1930,Samuel Kalu,4,2020-2021,22,ng NGA,Bordeaux,fr Ligue 1,20,964,10.7,14,6,0,4,1,5,4,0,0,0,FWMF,b8d22478,Rotational Player
1931,Marc Cardona,4,2023-2024,28,es ESP,Las Palmas,es La Liga,26,737,8.2,6,20,10,4,1,5,3,1,1,0,FW,b92b456a,Bench Player
1932,Francesco Acerbi,4,2021-2022,33,it ITA,Lazio,it Serie A,30,2536,28.2,29,1,0,4,0,4,4,0,0,0,DF,b96b595c,Full Starter
1933,Václav Černý,4,2023-2024,25,cz CZE,Wolfsburg,de Bundesliga,22,921,10.2,12,10,8,4,1,5,4,0,0,0,FWMF,bb1cf301,Rotational Player
1934,Jessic Ngankam,4,2022-2023,22,de GER,Hertha BSC,de Bundesliga,18,826,9.2,8,10,0,4,0,4,3,1,1,0,FWMF,bc249af8,Bench Player
1935,Jonathan Tah,4,2023-2024,27,de GER,Leverkusen,de Bundesliga,31,2631,29.2,30,1,2,4,1,5,4,0,0,0,DF,bd142efb,Full Starter
1936,Oihan Sancet,4,2023-2024,23,es ESP,Athletic Club,es La Liga,30,1975,21.9,25,5,1,4,5,9,4,0,1,1,MF,bdb624a3,Rotational Player
1937,Isaac Romero,4,2023-2024,23,es ESP,Sevilla,es La Liga,14,1039,11.5,14,0,0,4,4,8,4,0,0,0,FW,be719093,Rotational Player
1938,Renaud Ripart,4,2022-2023,29,fr FRA,Troyes,fr Ligue 1,26,1320,14.7,15,11,2,4,1,5,4,0,0,0,FWMF,beae3a73,Rotational Player
1939,Abde Ezzalzouli,4,2022-2023,20,ma MAR,Osasuna,es La Liga,28,1504,16.7,19,9,0,4,2,6,4,0,0,0,FWMF,bed68338,Rotational Player
1940,Roland Sallai,4,2021-2022,24,hu HUN,Freiburg,de Bundesliga,31,1551,17.2,18,13,0,4,4,8,4,0,0,0,MFFW,bf075f6b,Rotational Player
1941,Ismaila Sarr,4,2024-2025,26,sn SEN,Crystal Palace,eng Premier League,23,1502,16.7,16,7,0,4,3,7,4,0,0,0,MFFW,bfdb33aa,Rotational Player
1942,Iker Muniain,4,2021-2022,28,es ESP,Athletic Club,es La Liga,35,2785,30.9,34,1,2,4,10,14,3,1,3,2,MF,c05dfb74,Full Starter
1943,Wataru Endo,4,2021-2022,28,jp JPN,Stuttgart,de Bundesliga,33,2899,32.2,33,0,0,4,2,6,4,0,0,0,MF,c149016b,Full Starter
1944,Joelinton,4,2024-2025,27,br BRA,Newcastle Utd,eng Premier League,22,1851,20.6,22,0,0,4,1,5,4,0,0,0,MFFW,c17bfb65,Full Starter
1945,Joelinton,4,2021-2022,24,br BRA,Newcastle Utd,eng Premier League,35,2558,28.4,30,5,1,4,1,5,4,0,0,0,MFFW,c17bfb65,Full Starter
1946,Joelinton,4,2020-2021,23,br BRA,Newcastle Utd,eng Premier League,31,1983,22.0,23,8,6,4,2,6,3,1,1,0,FWMF,c17bfb65,Full Starter
1947,Konrad Laimer,4,2021-2022,24,at AUT,RB Leipzig,de Bundesliga,26,1240,13.8,15,11,3,4,4,8,4,0,0,0,MF,c1b7847c,Rotational Player
1948,Ellyes Skhiri,4,2021-2022,26,tn TUN,Köln,de Bundesliga,22,1820,20.2,20,2,0,4,1,5,4,0,0,0,MF,c2211709,Full Starter
1949,Alberto Moleiro,4,2024-2025,20,es ESP,Las Palmas,es La Liga,20,1519,16.9,18,2,1,4,0,4,4,0,0,0,FWMF,c2c8897d,Rotational Player
1950,Georginio Rutter,4,2024-2025,22,fr FRA,Brighton,eng Premier League,22,1177,13.1,13,9,0,4,2,6,4,0,0,0,FWMF,c64c01fc,Rotational Player
1951,Rafael Borré,4,2023-2024,27,co COL,Werder Bremen,de Bundesliga,19,991,11.0,11,8,1,4,0,4,4,0,0,0,FW,c68da769,Rotational Player
1952,Harry Wilson,4,2023-2024,26,wls WAL,Fulham,eng Premier League,35,1620,18.0,16,19,1,4,6,10,4,0,0,0,FW,c6dc9ecd,Rotational Player
1953,Shavy Babicka,4,2024-2025,24,ga GAB,Toulouse,fr Ligue 1,18,563,6.3,4,14,0,4,0,4,4,0,0,0,MFFW,c6f0d5d4,Bench Player
1954,Tonny Vilhena,4,2022-2023,27,nl NED,Salernitana,it Serie A,33,2265,25.2,27,6,4,4,1,5,4,0,0,0,MF,c7069d87,Full Starter
1955,Fabian Schär,4,2023-2024,31,ch SUI,Newcastle Utd,eng Premier League,36,3054,33.9,35,1,0,4,1,5,4,0,0,0,DF,c8aa95da,Full Starter
1956,Kelechi Iheanacho,4,2021-2022,24,ng NGA,Leicester City,eng Premier League,26,1264,14.0,13,13,9,4,5,9,4,0,0,0,FW,c92e1a31,Rotational Player
1957,Daniel James,4,2021-2022,23,wls WAL,2 Teams,eng Premier League,34,2492,27.7,31,3,1,4,4,8,4,0,0,0,FW,c931d9f9,Rotational Player
1958,Brais Méndez,4,2021-2022,24,es ESP,Celta Vigo,es La Liga,37,3021,33.6,36,1,0,4,5,9,4,0,0,0,MF,c9e39d91,Full Starter
1959,Patson Daka,4,2022-2023,23,zm ZAM,Leicester City,eng Premier League,30,1187,13.2,13,17,7,4,4,8,4,0,0,0,FW,ca45605e,Rotational Player
1960,Lucas Höler,4,2020-2021,26,de GER,Freiburg,de Bundesliga,33,2089,23.2,22,11,0,4,4,8,4,0,0,0,FWMF,ca618d23,Rotational Player
1961,Ibrahim Salah,4,2023-2024,21,ma MAR,Rennes,fr Ligue 1,23,524,5.8,4,19,6,4,1,5,4,0,0,0,FWMF,cad3fd4d,Bench Player
1962,Alexis Flips,4,2022-2023,22,fr FRA,Reims,fr Ligue 1,33,1978,22.0,28,5,3,4,6,10,4,0,0,0,FWMF,caef7840,Full Starter
1963,Vitor Roque,4,2024-2025,19,br BRA,Betis,es La Liga,18,1163,12.9,14,4,0,4,0,4,4,0,0,0,FW,cb00f1e6,Rotational Player
1964,Patrick Wimmer,4,2022-2023,21,at AUT,Wolfsburg,de Bundesliga,26,1648,18.3,23,3,0,4,8,12,4,0,0,0,FWMF,cb11b429,Rotational Player
1965,Juan Cruz,4,2024-2025,24,es ESP,Leganés,es La Liga,20,1255,13.9,14,6,1,4,1,5,4,0,0,0,FWMF,cc2dd8a5,Rotational Player
1966,Ezequiel Ponce,4,2022-2023,25,ar ARG,Elche,es La Liga,34,1129,12.5,8,26,2,4,0,4,4,0,0,0,FWMF,ccbbe661,Bench Player
1967,Hakan Çalhanoğlu,4,2024-2025,30,tr TUR,Inter,it Serie A,13,871,9.7,12,1,1,4,2,6,1,3,4,1,MF,cd0fa27b,Full Starter
1968,Hakan Çalhanoğlu,4,2020-2021,26,tr TUR,Milan,it Serie A,33,2614,29.0,30,3,0,4,9,13,3,1,1,0,MFFW,cd0fa27b,Full Starter
1969,Sebastian Nanasi,4,2024-2025,22,se SWE,Strasbourg,fr Ligue 1,18,1358,15.1,17,1,0,4,3,7,4,0,0,0,FWMF,ce747d2a,Rotational Player
1970,Daniel Caligiuri,4,2021-2022,33,it ITA,Augsburg,de Bundesliga,28,2004,22.3,24,4,4,4,2,6,1,3,3,0,DFMF,d1273f09,Full Starter
1971,Adrien Hunou,4,2022-2023,28,fr FRA,Angers,fr Ligue 1,34,2234,24.8,28,6,4,4,1,5,4,0,0,0,MFFW,d14229f3,Rotational Player
1972,Adrien Hunou,4,2020-2021,26,fr FRA,Rennes,fr Ligue 1,20,589,6.5,5,15,13,4,0,4,4,0,0,0,FWMF,d14229f3,Rotational Player
1973,Daniel Didavi,4,2020-2021,30,de GER,Stuttgart,de Bundesliga,23,970,10.8,10,13,5,4,3,7,4,0,0,0,MFFW,d3096421,Rotational Player
1974,Leonardo Pavoletti,4,2023-2024,34,it ITA,Cagliari,it Serie A,19,628,7.0,5,14,9,4,1,5,4,0,0,0,FW,d37b0350,Rotational Player
1975,Leonardo Pavoletti,4,2020-2021,31,it ITA,Cagliari,it Serie A,33,1584,17.6,17,16,4,4,3,7,4,0,0,0,FW,d37b0350,Rotational Player
1976,Nikola Kalinić,4,2021-2022,33,hr CRO,Hellas Verona,it Serie A,14,406,4.5,4,10,3,4,1,5,4,0,0,0,FW,d4931a5a,Bench Player
1977,Theo Hernández,4,2022-2023,24,fr FRA,Milan,it Serie A,32,2771,30.8,32,0,2,4,3,7,3,1,1,0,DF,d4c9725f,Full Starter
1978,Daniel Wass,4,2020-2021,31,dk DEN,Valencia,es La Liga,35,2979,33.1,35,0,2,4,1,5,3,1,1,0,MFDF,d83bbc54,Full Starter
1979,Willian José,4,2020-2021,28,br BRA,2 Teams,2 Comps,30,1799,20.0,20,10,6,4,1,5,4,0,1,1,FW,d87e2cae,Rotational Player
1980,Kenan Yıldız,4,2024-2025,19,tr TUR,Juventus,it Serie A,22,1520,16.9,17,5,0,4,2,6,4,0,0,0,FWMF,d8cda243,Rotational Player
1981,Scott McTominay,4,2020-2021,23,sct SCO,Manchester Utd,eng Premier League,32,2129,23.7,24,8,4,4,1,5,4,0,0,0,MF,d93c2511,Rotational Player
1982,Keito Nakamura,4,2023-2024,23,jp JPN,Reims,fr Ligue 1,25,1381,15.3,17,8,1,4,1,5,4,0,0,0,FWMF,d97af612,Rotational Player
1983,Giacomo Bonaventura,4,2021-2022,31,it ITA,Fiorentina,it Serie A,31,2266,25.2,28,3,1,4,4,8,4,0,0,0,MF,d995ed27,Full Starter
1984,Jordan Ayew,4,2024-2025,32,gh GHA,2 Teams,eng Premier League,21,1101,12.2,12,9,1,4,0,4,3,1,1,0,FWMF,da052c14,Rotational Player
1985,Jordan Ayew,4,2023-2024,31,gh GHA,Crystal Palace,eng Premier League,35,2543,28.3,30,5,1,4,7,11,4,0,0,0,FWMF,da052c14,Rotational Player
1986,Jordan Ayew,4,2022-2023,30,gh GHA,Crystal Palace,eng Premier League,38,2714,30.2,31,7,0,4,3,7,4,0,0,0,FWMF,da052c14,Rotational Player
1987,Xavi Simons,4,2024-2025,21,nl NED,RB Leipzig,de Bundesliga,11,924,10.3,11,0,0,4,2,6,4,0,0,0,MF,da4d670f,Rotational Player
1988,Valentín Castellanos,4,2023-2024,24,ar ARG,Lazio,it Serie A,35,1682,18.7,16,19,2,4,3,7,4,0,0,0,FW,da76bab4,Rotational Player
1989,Adri Embarba,4,2022-2023,30,es ESP,2 Teams,es La Liga,30,1507,16.7,18,12,5,4,3,7,3,1,1,0,FWMF,db8f0eba,Rotational Player
1990,Junya Ito,4,2024-2025,31,jp JPN,Reims,fr Ligue 1,19,1669,18.5,19,0,0,4,3,7,4,0,0,0,FW,dbd3a428,Full Starter
1991,Álex Berenguer,4,2022-2023,27,es ESP,Athletic Club,es La Liga,37,2297,25.5,26,11,1,4,1,5,4,0,0,0,FW,dc1c2fce,Rotational Player
1992,Leonardo Bittencourt,4,2020-2021,26,de GER,Werder Bremen,de Bundesliga,27,1514,16.8,19,8,4,4,1,5,3,1,1,0,MFFW,dc62fbee,Rotational Player
1993,Bas Dost,4,2020-2021,31,nl NED,Eint Frankfurt,de Bundesliga,12,817,9.1,9,3,1,4,2,6,3,1,1,0,FW,dc90cfbe,Bench Player
1994,Amine Adli,4,2023-2024,23,ma MAR,Leverkusen,de Bundesliga,23,898,10.0,8,15,4,4,6,10,4,0,0,0,MFFW,dcfb17f4,Rotational Player
1995,Jacob Murphy,4,2022-2023,27,eng ENG,Newcastle Utd,eng Premier League,36,1251,13.9,14,22,1,4,2,6,4,0,0,0,FW,de112b84,Rotational Player
1996,Crysencio Summerville,4,2022-2023,20,nl NED,Leeds United,eng Premier League,28,1426,15.8,12,16,8,4,2,6,4,0,0,0,FW,df04eb4b,Rotational Player
1997,Dejan Kulusevski,4,2020-2021,20,se SWE,Juventus,it Serie A,35,1923,21.4,19,16,2,4,3,7,4,0,0,0,MFFW,df3cda47,Rotational Player
1998,Arthur Theate,4,2022-2023,22,be BEL,Rennes,fr Ligue 1,35,3127,34.7,35,0,1,4,0,4,4,0,0,0,DF,df8d6029,Full Starter
1999,Marco Brescianini,4,2023-2024,23,it ITA,Frosinone,it Serie A,36,2321,25.8,24,12,1,4,2,6,4,0,0,0,MF,dfd56738,Rotational Player
2000,Paulo Dybala,4,2020-2021,26,ar ARG,Juventus,it Serie A,20,1132,12.6,14,6,4,4,3,7,4,0,0,0,FW,e0921a4f,Rotational Player
2001,Ivan Toney,4,2023-2024,27,eng ENG,Brentford,eng Premier League,17,1450,16.1,16,1,1,4,2,6,4,0,0,0,FW,e09f279b,Full Starter
2002,Robert Andrich,4,2021-2022,26,de GER,Leverkusen,de Bundesliga,26,1817,20.2,21,5,1,4,2,6,4,0,0,0,MF,e0b113a7,Rotational Player
2003,Robert Andrich,4,2023-2024,28,de GER,Leverkusen,de Bundesliga,28,1690,18.8,18,10,6,4,2,6,4,0,0,0,MFDF,e0b113a7,Rotational Player
2004,Sebastian Rode,4,2022-2023,31,de GER,Eint Frankfurt,de Bundesliga,27,1414,15.7,19,8,1,4,1,5,4,0,0,0,MF,e12b0b5b,Rotational Player
2005,Marcel Sabitzer,4,2023-2024,29,at AUT,Dortmund,de Bundesliga,25,1961,21.8,23,2,2,4,3,7,3,1,1,0,MF,e280527c,Rotational Player
2006,Shamar Nicholson,4,2023-2024,26,jm JAM,Clermont Foot,fr Ligue 1,26,1484,16.5,17,9,2,4,3,7,3,1,2,1,FW,e33fb79d,Rotational Player
2007,Achraf Hakimi,4,2021-2022,22,ma MAR,Paris S-G,fr Ligue 1,32,2479,27.5,28,4,0,4,6,10,4,0,0,0,DF,e42d61c7,Rotational Player
2008,Achraf Hakimi,4,2023-2024,24,ma MAR,Paris S-G,fr Ligue 1,25,1932,21.5,20,5,3,4,5,9,4,0,0,0,DF,e42d61c7,Rotational Player
2009,Kevin De Bruyne,4,2023-2024,32,be BEL,Manchester City,eng Premier League,18,1221,13.6,15,3,3,4,10,14,4,0,0,0,MF,e46012d4,Rotational Player
2010,Luca Waldschmidt,4,2022-2023,26,de GER,Wolfsburg,de Bundesliga,18,523,5.8,4,14,12,4,0,4,3,1,1,0,FWMF,e5a35ae9,Bench Player
2011,Fábio Silva,4,2020-2021,18,pt POR,Wolves,eng Premier League,32,1369,15.2,11,21,6,4,3,7,3,1,1,0,FW,e7aa9d7c,Rotational Player
2012,Amine Harit,4,2021-2022,24,ma MAR,Marseille,fr Ligue 1,23,1165,12.9,12,11,7,4,4,8,4,0,0,0,FWMF,e7d59f4f,Rotational Player
2013,Oscar Vilhelmsson,4,2023-2024,19,se SWE,Darmstadt 98,de Bundesliga,26,1374,15.3,16,10,2,4,1,5,4,0,0,0,FWMF,e7f4869a,Rotational Player
2014,Exequiel Palacios,4,2022-2023,23,ar ARG,Leverkusen,de Bundesliga,25,1654,18.4,19,6,1,4,2,6,1,3,3,0,MF,e82adcab,Rotational Player
2015,Exequiel Palacios,4,2023-2024,24,ar ARG,Leverkusen,de Bundesliga,24,1831,20.3,21,3,3,4,4,8,2,2,2,0,MF,e82adcab,Rotational Player
2016,Alexander Sørloth,4,2021-2022,25,no NOR,Real Sociedad,es La Liga,33,1763,19.6,20,13,0,4,0,4,4,0,0,0,FW,e92cd3f7,Rotational Player
2017,Remi Oudin,4,2020-2021,23,fr FRA,Bordeaux,fr Ligue 1,38,2420,26.9,27,11,0,4,4,8,4,0,0,0,FWMF,ea02beaf,Rotational Player
2018,Remi Oudin,4,2021-2022,24,fr FRA,Bordeaux,fr Ligue 1,33,1737,19.3,20,13,2,4,5,9,4,0,0,0,MFFW,ea02beaf,Rotational Player
2019,Valère Germain,4,2021-2022,31,fr FRA,Montpellier,fr Ligue 1,34,1970,21.9,22,12,0,4,3,7,4,0,0,0,FW,ea0ff634,Rotational Player
2020,Moanes Dabbur,4,2020-2021,28,il ISR,Hoffenheim,de Bundesliga,22,999,11.1,11,11,7,4,0,4,4,0,1,1,FWMF,eac044ad,Rotational Player
2021,Luis Rioja,4,2020-2021,26,es ESP,Alavés,es La Liga,35,2090,23.2,25,10,3,4,2,6,4,0,0,0,MFFW,eb3dd471,Rotational Player
2022,Luis Rioja,4,2024-2025,30,es ESP,2 Teams,es La Liga,21,1674,18.6,19,2,0,4,0,4,2,2,2,0,FW,eb3dd471,Rotational Player
2023,Florian Tardieu,4,2021-2022,29,fr FRA,Troyes,fr Ligue 1,30,2632,29.2,29,1,0,4,2,6,0,4,4,0,MF,ed39121c,Rotational Player
2024,Darwin Machís,4,2021-2022,28,ve VEN,Granada,es La Liga,25,1376,15.3,16,9,5,4,2,6,4,0,0,0,MFFW,ed6ea4d9,Rotational Player
2025,Darwin Machís,4,2023-2024,30,ve VEN,Cádiz,es La Liga,21,785,8.7,10,11,12,4,0,4,3,1,1,0,MF,ed6ea4d9,Rotational Player
2026,Adam Ounas,4,2020-2021,23,dz ALG,2 Teams,it Serie A,22,1507,16.7,18,4,2,4,4,8,4,0,0,0,FWMF,ed90babd,Rotational Player
2027,Alexis Saelemaekers,4,2024-2025,25,be BEL,2 Teams,it Serie A,11,727,8.1,10,1,2,4,1,5,4,0,0,0,DFFW,ee251371,Rotational Player
2028,Alexis Saelemaekers,4,2023-2024,24,be BEL,Bologna,it Serie A,30,1887,21.0,21,9,1,4,2,6,4,0,0,0,FWMF,ee251371,Rotational Player
2029,James Maddison,4,2023-2024,26,eng ENG,Tottenham,eng Premier League,28,2135,23.7,26,2,0,4,9,13,4,0,0,0,MF,ee38d9c5,Rotational Player
2030,Fabio Quagliarella,4,2021-2022,38,it ITA,Sampdoria,it Serie A,33,1664,18.5,19,14,3,4,2,6,3,1,1,0,FW,ee4f2f3b,Rotational Player
2031,Gustavo Hamer,4,2023-2024,26,nl NED,Sheffield Utd,eng Premier League,36,2910,32.3,34,2,0,4,6,10,4,0,0,0,MF,eebacc07,Full Starter
2032,Benjamin André,4,2023-2024,32,fr FRA,Lille,fr Ligue 1,30,2570,28.6,29,1,0,4,0,4,4,0,0,0,MF,ef9c1c95,Full Starter
2033,Dany Mota,4,2023-2024,25,pt POR,Monza,it Serie A,34,2049,22.8,24,10,1,4,3,7,4,0,0,0,FWMF,efc9e31f,Rotational Player
2034,Dany Mota,4,2024-2025,26,pt POR,Monza,it Serie A,16,1013,11.3,12,4,0,4,0,4,4,0,0,0,MFFW,efc9e31f,Rotational Player
2035,Karim Onisiwo,4,2020-2021,28,at AUT,Mainz 05,de Bundesliga,31,1843,20.5,19,12,0,4,0,4,4,0,0,0,FWMF,f26834c7,Rotational Player
2036,Stevan Jovetić,4,2022-2023,32,me MNE,Hertha BSC,de Bundesliga,17,892,9.9,8,9,2,4,2,6,4,0,0,0,FWMF,f36c432f,Bench Player
2037,Marcos Alonso,4,2021-2022,30,es ESP,Chelsea,eng Premier League,28,2167,24.1,25,3,6,4,4,8,4,0,0,0,DF,f4290206,Rotational Player
2038,Pierre Lees-Melou,4,2023-2024,30,fr FRA,Brest,fr Ligue 1,29,2517,28.0,29,0,0,4,0,4,4,0,0,0,MF,f5044e54,Full Starter
2039,Pierre Lees-Melou,4,2020-2021,27,fr FRA,Nice,fr Ligue 1,29,2063,22.9,23,6,1,4,2,6,3,1,1,0,MF,f5044e54,Full Starter
2040,Matthias Ginter,4,2022-2023,28,de GER,Freiburg,de Bundesliga,34,3060,34.0,34,0,0,4,1,5,4,0,0,0,DF,f521b80a,Full Starter
2041,Jørgen Strand Larsen,4,2022-2023,22,no NOR,Celta Vigo,es La Liga,32,1705,18.9,20,12,2,4,4,8,4,0,0,0,FW,f553b2b3,Full Starter
2042,Silvan Widmer,4,2021-2022,28,ch SUI,Mainz 05,de Bundesliga,33,2920,32.4,33,0,0,4,5,9,4,0,0,0,DF,f68b64fc,Full Starter
2043,Enzo Millot,4,2024-2025,22,fr FRA,Stuttgart,de Bundesliga,18,1165,12.9,14,4,0,4,2,6,4,0,1,1,MFFW,f76022e7,Rotational Player
2044,Aritz Elustondo,4,2021-2022,27,es ESP,Real Sociedad,es La Liga,30,2105,23.4,22,8,6,4,1,5,4,0,0,0,DF,f7dc2ae5,Rotational Player
2045,Maxence Caqueret,4,2022-2023,22,fr FRA,Lyon,fr Ligue 1,36,2767,30.7,32,4,1,4,7,11,4,0,0,0,MF,f81ef10d,Full Starter
2046,Mohamed Ali Cho,4,2021-2022,17,fr FRA,Angers,fr Ligue 1,32,1837,20.4,21,11,0,4,1,5,4,0,0,0,FW,f8405304,Rotational Player
2047,Enes Ünal,4,2020-2021,23,tr TUR,Getafe,es La Liga,28,1318,14.6,15,13,2,4,2,6,3,1,1,0,FW,f8eca1b6,Full Starter
2048,Emmanuel Gyasi,4,2020-2021,26,gh GHA,Spezia,it Serie A,37,2851,31.7,32,5,1,4,6,10,4,0,0,0,FW,f9758dae,Full Starter
2049,Luiz Araújo,4,2020-2021,24,br BRA,Lille,fr Ligue 1,28,1496,16.6,17,11,2,4,2,6,4,0,0,0,MF,fa18c72e,Rotational Player
2050,Lucas Vázquez,4,2022-2023,31,es ESP,Real Madrid,es La Liga,23,1144,12.7,12,11,9,4,1,5,4,0,0,0,DF,fd51b456,Rotational Player
2051,Jeremie Boga,4,2020-2021,23,ci CIV,Sassuolo,it Serie A,27,1785,19.8,20,7,2,4,2,6,4,0,0,0,FWMF,fe012aca,Rotational Player
2052,Carlos Soler,4,2022-2023,25,es ESP,2 Teams,2 Comps,29,1429,15.9,17,12,5,4,2,6,3,1,1,0,MF,fed17f5a,Full Starter
2053,Kai Havertz,4,2020-2021,21,de GER,Chelsea,eng Premier League,27,1520,16.9,18,9,4,4,3,7,4,0,0,0,MFFW,fed7cb61,Rotational Player
2054,Jeremy Doku,4,2023-2024,21,be BEL,2 Teams,2 Comps,31,1706,19.0,19,12,2,4,8,12,4,0,0,0,FW,fffea3e5,Rotational Player
2055,Moussa Niakhate,3,2020-2021,24,sn SEN,Mainz 05,de Bundesliga,32,2866,31.8,32,0,0,3,1,4,2,1,1,0,DF,00242715,Full Starter
2056,Tete Morente,3,2021-2022,24,es ESP,Elche,es La Liga,32,1632,18.1,18,14,5,3,3,6,3,0,0,0,MF,004d185e,Rotational Player
2057,Tete Morente,3,2024-2025,27,es ESP,Lecce,it Serie A,18,1094,12.2,12,6,4,3,1,4,3,0,0,0,FWMF,004d185e,Rotational Player
2058,Nemanja Gudelj,3,2022-2023,30,rs SRB,Sevilla,es La Liga,34,2779,30.9,31,3,2,3,1,4,3,0,0,0,DFMF,0076ab7f,Full Starter
2059,Przemysław Frankowski,3,2023-2024,28,pl POL,Lens,fr Ligue 1,30,2192,24.4,24,6,2,3,2,5,2,1,2,1,DF,00a8d210,Rotational Player
2060,Weston McKennie,3,2021-2022,22,us USA,Juventus,it Serie A,21,1369,15.2,15,6,2,3,0,3,3,0,0,0,MF,01c3aff5,Rotational Player
2061,Joshua Zirkzee,3,2024-2025,23,nl NED,Manchester Utd,eng Premier League,23,864,9.6,8,15,0,3,1,4,3,0,0,0,FWMF,028e70b9,Rotational Player
2062,Bilal Brahimi,3,2022-2023,22,dz ALG,Nice,fr Ligue 1,26,800,8.9,5,21,10,3,2,5,3,0,0,0,FWMF,02bcaf8e,Bench Player
2063,Manuel Lazzari,3,2021-2022,27,it ITA,Lazio,it Serie A,31,1665,18.5,16,15,3,3,3,6,3,0,0,0,DF,02caf6e0,Rotational Player
2064,Rubén Alcaraz,3,2023-2024,32,es ESP,Cádiz,es La Liga,36,3134,34.8,36,0,0,3,1,4,1,2,2,0,MF,036bba5f,Rotational Player
2065,Rubén Alcaraz,3,2022-2023,31,es ESP,Cádiz,es La Liga,31,2043,22.7,22,9,0,3,0,3,1,2,3,1,MF,036bba5f,Rotational Player
2066,Andrea Petagna,3,2021-2022,26,it ITA,Napoli,it Serie A,24,586,6.5,4,20,11,3,1,4,3,0,0,0,FW,03f946ed,Rotational Player
2067,Kingsley Coman,3,2023-2024,27,fr FRA,Bayern Munich,de Bundesliga,17,1113,12.4,15,2,1,3,3,6,3,0,0,0,FW,042e8a49,Rotational Player
2068,Kingsley Coman,3,2024-2025,28,fr FRA,Bayern Munich,de Bundesliga,17,800,8.9,8,9,0,3,2,5,3,0,0,0,FW,042e8a49,Rotational Player
2069,Raphaël Guerreiro,3,2023-2024,29,pt POR,Bayern Munich,de Bundesliga,20,1191,13.2,13,7,2,3,0,3,3,0,0,0,DFMF,048a1cbc,Rotational Player
2070,Pablo Torre,3,2024-2025,21,es ESP,Barcelona,es La Liga,8,261,2.9,4,4,13,3,1,4,3,0,0,0,MFFW,04e531b6,Bench Player
2071,Frank Tsadjout,3,2022-2023,23,it ITA,Cremonese,it Serie A,20,1051,11.7,14,6,13,3,1,4,3,0,0,0,FW,0588a092,Rotational Player
2072,Mats Hummels,3,2023-2024,34,de GER,Dortmund,de Bundesliga,25,1581,17.6,20,5,4,3,0,3,3,0,0,0,DF,05d548d8,Full Starter
2073,Nemanja Radonjić,3,2023-2024,27,rs SRB,2 Teams,2 Comps,21,727,8.1,8,13,10,3,0,3,3,0,0,0,MFFW,0630eb63,Rotational Player
2074,Nemanja Radonjić,3,2020-2021,24,rs SRB,2 Teams,2 Comps,24,1007,11.2,9,15,5,3,3,6,3,0,0,0,FW,0630eb63,Rotational Player
2075,Benoît Badiashile,3,2022-2023,21,fr FRA,2 Teams,2 Comps,22,1744,19.4,19,3,9,3,0,3,3,0,0,0,DF,06df8256,Full Starter
2076,Sergi Darder,3,2021-2022,27,es ESP,Espanyol,es La Liga,36,3125,34.7,36,0,0,3,9,12,3,0,0,0,MF,070a3904,Full Starter
2077,Srđan Babić,3,2022-2023,26,rs SRB,Almería,es La Liga,34,2998,33.3,33,1,3,3,0,3,3,0,0,0,DF,075fe5a3,Full Starter
2078,Sergio Ramos,3,2023-2024,37,es ESP,Sevilla,es La Liga,28,2517,28.0,28,0,3,3,0,3,3,0,0,0,DF,08511d65,Rotational Player
2079,Felix Nmecha,3,2022-2023,21,de GER,Wolfsburg,de Bundesliga,30,1836,20.4,19,11,1,3,5,8,3,0,0,0,MF,091c86e2,Rotational Player
2080,Federico Valverde,3,2020-2021,22,uy URU,Real Madrid,es La Liga,24,1330,14.8,15,9,0,3,1,4,3,0,0,0,MF,0959c2a2,Rotational Player
2081,Arber Zeneli,3,2020-2021,25,xk KVX,Reims,fr Ligue 1,28,1289,14.3,14,14,3,3,3,6,3,0,0,0,MFFW,095e4199,Bench Player
2082,Andrey Galabinov,3,2020-2021,31,bg BUL,Spezia,it Serie A,12,430,4.8,4,8,10,3,1,4,3,0,1,1,FW,0a1efd3c,Bench Player
2083,Christopher Antwi-Adjei,3,2022-2023,28,gh GHA,Bochum,de Bundesliga,29,1981,22.0,22,7,2,3,6,9,3,0,0,0,FWMF,0a3f6cde,Rotational Player
2084,Kike Salas,3,2023-2024,21,es ESP,Sevilla,es La Liga,23,1605,17.8,19,4,6,3,0,3,3,0,0,0,DF,0a69de7b,Rotational Player
2085,Benjamin Henrichs,3,2021-2022,24,de GER,RB Leipzig,de Bundesliga,22,1143,12.7,12,10,8,3,3,6,3,0,0,0,DF,0a89e877,Rotational Player
2086,Jorge Cuenca,3,2023-2024,23,es ESP,Villarreal,es La Liga,29,1963,21.8,21,8,6,3,1,4,3,0,0,0,DF,0abc51f2,Rotational Player
2087,Raúl Guti,3,2020-2021,23,es ESP,Elche,es La Liga,36,2862,31.8,33,3,1,3,1,4,3,0,0,0,MF,0b2c8585,Full Starter
2088,Vedat Muriqi,3,2024-2025,30,xk KVX,Mallorca,es La Liga,16,1111,12.3,12,4,0,3,2,5,3,0,0,0,FW,0cadc46d,Rotational Player
2089,Kaio Jorge,3,2023-2024,21,br BRA,Frosinone,it Serie A,20,812,9.0,8,12,11,3,0,3,2,1,2,1,FW,0cf465f2,Bench Player
2090,Chris Führich,3,2021-2022,23,de GER,Stuttgart,de Bundesliga,25,1714,19.0,21,4,0,3,2,5,3,0,0,0,FWMF,0cf778df,Rotational Player
2091,Matěj Vydra,3,2020-2021,28,cz CZE,Burnley,eng Premier League,28,1371,15.2,15,13,5,3,2,5,3,0,0,0,FW,0d4ceb32,Rotational Player
2092,Elye Wahi,3,2020-2021,17,fr FRA,Montpellier,fr Ligue 1,18,555,6.2,3,15,5,3,1,4,3,0,0,0,FW,0d7b6576,Rotational Player
2093,Elye Wahi,3,2024-2025,21,fr FRA,Marseille,fr Ligue 1,13,574,6.4,7,6,2,3,1,4,2,1,1,0,FW,0d7b6576,Rotational Player
2094,Pedri,3,2020-2021,17,es ESP,Barcelona,es La Liga,37,2415,26.8,28,9,0,3,3,6,3,0,0,0,MF,0d9b2d31,Rotational Player
2095,Pedri,3,2021-2022,18,es ESP,Barcelona,es La Liga,12,885,9.8,10,2,0,3,1,4,3,0,0,0,MF,0d9b2d31,Rotational Player
2096,Omar Marmoush,3,2021-2022,22,eg EGY,2 Teams,de Bundesliga,23,1595,17.7,19,4,1,3,5,8,3,0,1,1,FW,0e0102eb,Rotational Player
2097,Matthis Abline,3,2022-2023,19,fr FRA,2 Teams,fr Ligue 1,30,913,10.1,8,22,5,3,1,4,2,1,2,1,FWMF,0e46fa2f,Rotational Player
2098,Lucas Torró,3,2024-2025,30,es ESP,Osasuna,es La Liga,19,1640,18.2,19,0,1,3,0,3,3,0,0,0,MF,0e4fef6e,Rotational Player
2099,Eric Maxim Choupo-Moting,3,2020-2021,31,cm CMR,Bayern Munich,de Bundesliga,22,820,9.1,8,14,7,3,0,3,3,0,0,0,FWMF,0e6bc38c,Bench Player
2100,Mathias Jensen,3,2023-2024,27,dk DEN,Brentford,eng Premier League,32,2204,24.5,27,5,0,3,3,6,3,0,0,0,MF,0f134faf,Full Starter
2101,Dominik Kohr,3,2022-2023,28,de GER,Mainz 05,de Bundesliga,30,2292,25.5,27,3,1,3,0,3,3,0,0,0,MF,0fbecd11,Full Starter
2102,Martin Erlic,3,2020-2021,22,hr CRO,Spezia,it Serie A,27,1798,20.0,19,8,6,3,1,4,3,0,0,0,DF,0fee6bda,Rotational Player
2103,Ryad Boudebouz,3,2021-2022,31,dz ALG,Saint-Étienne,fr Ligue 1,30,2252,25.0,27,3,1,3,4,7,2,1,1,0,MFFW,1001ae82,Full Starter
2104,Alexsandro Ribeiro,3,2022-2023,22,br BRA,Lille,fr Ligue 1,21,1612,17.9,16,5,15,3,0,3,3,0,0,0,DF,102c9665,Rotational Player
2105,Sardar Azmoun,3,2023-2024,28,ir IRN,Roma,it Serie A,23,585,6.5,3,20,6,3,0,3,3,0,0,0,FWMF,10549b49,Bench Player
2106,Jamie Gittens,3,2022-2023,17,eng ENG,Dortmund,de Bundesliga,15,533,5.9,4,11,3,3,1,4,3,0,0,0,FWMF,10745192,Bench Player
2107,Marvin Mehlem,3,2023-2024,25,de GER,Darmstadt 98,de Bundesliga,20,1482,16.5,19,1,1,3,2,5,3,0,0,0,MF,10876d02,Rotational Player
2108,Gaëtan Perrin,3,2022-2023,26,fr FRA,Auxerre,fr Ligue 1,37,1391,15.5,15,22,0,3,1,4,2,1,1,0,MFFW,10dd88f9,Rotational Player
2109,Sergi Canós,3,2021-2022,24,es ESP,Brentford,eng Premier League,31,2083,23.1,25,6,2,3,2,5,3,0,0,0,DFFW,1137759d,Rotational Player
2110,Marvin Pieringer,3,2023-2024,23,de GER,Heidenheim,de Bundesliga,31,1513,16.8,18,13,0,3,3,6,3,0,0,0,MFFW,11407d95,Rotational Player
2111,Donyell Malen,3,2024-2025,25,nl NED,2 Teams,2 Comps,15,640,7.1,6,9,3,3,0,3,3,0,0,0,FWMF,116c35df,Rotational Player
2112,Alberto Moreno,3,2021-2022,29,es ESP,Villarreal,es La Liga,24,1223,13.6,13,11,3,3,2,5,3,0,0,0,MFDF,11b9265b,Rotational Player
2113,Davie Selke,3,2020-2021,25,de GER,Werder Bremen,de Bundesliga,23,813,9.0,7,16,4,3,1,4,2,1,1,0,FW,1238a3f9,Rotational Player
2114,Takuma Asano,3,2022-2023,27,jp JPN,Bochum,de Bundesliga,25,1713,19.0,21,4,0,3,3,6,3,0,0,0,FWMF,13ddc856,Rotational Player
2115,Takuma Asano,3,2021-2022,26,jp JPN,Bochum,de Bundesliga,27,1608,17.9,20,7,1,3,4,7,3,0,0,0,FWMF,13ddc856,Rotational Player
2116,Callum Hudson-Odoi,3,2024-2025,23,eng ENG,Nott'ham Forest,eng Premier League,20,1525,16.9,18,2,1,3,2,5,3,0,0,0,FWMF,15f3ec41,Rotational Player
2117,Rodrigo De Paul,3,2021-2022,27,ar ARG,Atlético Madrid,es La Liga,36,2151,23.9,24,12,1,3,1,4,3,0,0,0,MF,162efffd,Rotational Player
2118,Rodrigo De Paul,3,2023-2024,29,ar ARG,Atlético Madrid,es La Liga,34,2075,23.1,25,9,0,3,5,8,3,0,0,0,MF,162efffd,Rotational Player
2119,Rodrigo De Paul,3,2024-2025,30,ar ARG,Atlético Madrid,es La Liga,20,1118,12.4,11,9,0,3,3,6,3,0,0,0,MF,162efffd,Rotational Player
2120,Bryan Cristante,3,2023-2024,28,it ITA,Roma,it Serie A,37,3289,36.5,37,0,0,3,4,7,3,0,0,0,MFDF,16657b95,Full Starter
2121,Hwang Hee-chan,3,2022-2023,26,kr KOR,Wolves,eng Premier League,27,1130,12.6,12,15,2,3,1,4,3,0,0,0,FWMF,169fd162,Rotational Player
2122,Brendan Chardonnet,3,2020-2021,25,fr FRA,Brest,fr Ligue 1,33,2716,30.2,30,3,3,3,1,4,3,0,0,0,DF,16aa7d4c,Full Starter
2123,Brendan Chardonnet,3,2021-2022,26,fr FRA,Brest,fr Ligue 1,32,2686,29.8,31,1,0,3,0,3,3,0,0,0,DF,16aa7d4c,Full Starter
2124,Pontus Jansson,3,2021-2022,30,se SWE,Brentford,eng Premier League,37,3321,36.9,37,0,0,3,1,4,3,0,0,0,DF,172e52d8,Full Starter
2125,Joseph Aidoo,3,2022-2023,26,gh GHA,Celta Vigo,es La Liga,35,3119,34.7,35,0,0,3,0,3,3,0,0,0,DF,18abe173,Full Starter
2126,Antonio Rüdiger,3,2021-2022,28,de GER,Chelsea,eng Premier League,34,3035,33.7,34,0,1,3,0,3,3,0,0,0,DF,18b896d6,Full Starter
2127,Kyle Bartley,3,2020-2021,29,eng ENG,West Brom,eng Premier League,30,2584,28.7,28,2,3,3,1,4,3,0,0,0,DF,18e96f64,Full Starter
2128,Jannik Vestergaard,3,2020-2021,27,dk DEN,Southampton,eng Premier League,30,2574,28.6,29,1,1,3,0,3,3,0,0,0,DF,1900032e,Full Starter
2129,André Gomes,3,2022-2023,29,pt POR,2 Teams,2 Comps,26,1629,18.1,18,8,1,3,2,5,3,0,0,0,MF,1961b2aa,Rotational Player
2130,Rubén Sobrino,3,2022-2023,30,es ESP,Cádiz,es La Liga,33,2465,27.4,28,5,1,3,2,5,3,0,0,0,MFFW,19b776e9,Rotational Player
2131,Luis Milla,3,2021-2022,26,es ESP,Granada,es La Liga,34,2773,30.8,33,1,0,3,3,6,0,3,3,0,MF,19c36442,Full Starter
2132,Youcef Belaïli,3,2021-2022,29,dz ALG,Brest,fr Ligue 1,13,825,9.2,11,2,1,3,2,5,3,0,1,1,MFFW,1a248246,Rotational Player
2133,Simone Bastoni,3,2021-2022,24,it ITA,Spezia,it Serie A,31,2288,25.4,26,5,1,3,3,6,3,0,0,0,MFDF,1ac232b8,Rotational Player
2134,Frenkie de Jong,3,2021-2022,24,nl NED,Barcelona,es La Liga,32,2476,27.5,30,2,1,3,3,6,3,0,0,0,MF,1bacc518,Rotational Player
2135,Frenkie de Jong,3,2020-2021,23,nl NED,Barcelona,es La Liga,37,3154,35.0,35,2,0,3,4,7,3,0,0,0,MFDF,1bacc518,Rotational Player
2136,Ablie Jallow,3,2023-2024,24,gm GAM,Metz,fr Ligue 1,17,918,10.2,10,7,4,3,2,5,2,1,1,0,MFFW,1bc6135b,Rotational Player
2137,Bafodé Diakité,3,2024-2025,23,fr FRA,Lille,fr Ligue 1,19,1710,19.0,19,0,0,3,1,4,3,0,0,0,DF,1bfb6fef,Rotational Player
2138,Bafodé Diakité,3,2022-2023,21,fr FRA,Lille,fr Ligue 1,33,2653,29.5,29,4,1,3,0,3,3,0,0,0,DF,1bfb6fef,Rotational Player
2139,Dara O'Shea,3,2023-2024,24,ie IRL,Burnley,eng Premier League,33,2892,32.1,32,1,1,3,4,7,3,0,0,0,DF,1d042188,Full Starter
2140,Marc Cucurella,3,2020-2021,22,es ESP,Getafe,es La Liga,37,3244,36.0,37,0,0,3,2,5,3,0,0,0,MF,1daec722,Full Starter
2141,Sven Michel,3,2021-2022,31,de GER,Union Berlin,de Bundesliga,13,338,3.8,2,11,1,3,1,4,3,0,0,0,FW,1e274a0a,Bench Player
2142,Sven Michel,3,2022-2023,32,de GER,Union Berlin,de Bundesliga,21,495,5.5,2,19,11,3,1,4,2,1,1,0,FWMF,1e274a0a,Bench Player
2143,Theo Walcott,3,2020-2021,31,eng ENG,2 Teams,eng Premier League,22,1631,18.1,20,2,4,3,3,6,3,0,0,0,MFFW,1ecb65be,Rotational Player
2144,Jens Stage,3,2022-2023,25,dk DEN,Werder Bremen,de Bundesliga,32,1855,20.6,21,11,1,3,3,6,3,0,0,0,MF,1fffae99,Rotational Player
2145,Jens Stage,3,2023-2024,26,dk DEN,Werder Bremen,de Bundesliga,30,2327,25.9,26,4,0,3,1,4,3,0,0,0,MF,1fffae99,Rotational Player
2146,Ander Barrenetxea,3,2020-2021,18,es ESP,Real Sociedad,es La Liga,31,1307,14.5,13,18,5,3,0,3,3,0,0,0,MFFW,200e89e1,Rotational Player
2147,Ander Barrenetxea,3,2022-2023,20,es ESP,Real Sociedad,es La Liga,23,878,9.8,9,14,5,3,1,4,3,0,0,0,FWDF,200e89e1,Rotational Player
2148,M'Baye Niang,3,2021-2022,26,sn SEN,Bordeaux,fr Ligue 1,22,777,8.6,7,15,4,3,1,4,3,0,0,0,FW,2054d037,Bench Player
2149,Nicolás Domínguez,3,2022-2023,24,ar ARG,Bologna,it Serie A,31,2300,25.6,26,5,1,3,2,5,3,0,0,0,MF,20b3a502,Rotational Player
2150,Amin Younes,3,2020-2021,26,de GER,Eint Frankfurt,de Bundesliga,26,1391,15.5,16,10,0,3,3,6,3,0,0,0,MF,228f73ae,Rotational Player
2151,Domen Črnigoj,3,2021-2022,25,si SVN,Venezia,it Serie A,34,1881,20.9,22,12,1,3,1,4,3,0,0,0,MF,22cd43d2,Rotational Player
2152,Giovanni Di Lorenzo,3,2024-2025,30,it ITA,Napoli,it Serie A,22,1980,22.0,22,0,0,3,1,4,3,0,0,0,DF,230a2fac,Full Starter
2153,Giovanni Di Lorenzo,3,2022-2023,28,it ITA,Napoli,it Serie A,37,3257,36.2,36,1,1,3,4,7,3,0,0,0,DF,230a2fac,Full Starter
2154,Giovanni Di Lorenzo,3,2020-2021,26,it ITA,Napoli,it Serie A,36,3240,36.0,36,0,0,3,6,9,3,0,0,0,DF,230a2fac,Full Starter
2155,Ernest Nuamah,3,2023-2024,19,gh GHA,Lyon,fr Ligue 1,29,1838,20.4,21,8,0,3,2,5,3,0,0,0,FWMF,234a703c,Rotational Player
2156,Elba Rashani,3,2022-2023,29,xk KVX,Clermont Foot,fr Ligue 1,32,2162,24.0,26,6,0,3,3,6,3,0,0,0,MFFW,25749008,Rotational Player
2157,Yacine Adli,3,2024-2025,24,fr FRA,Fiorentina,it Serie A,19,1105,12.3,13,6,0,3,4,7,3,0,0,0,MF,26777636,Rotational Player
2158,Ashley Barnes,3,2020-2021,30,eng ENG,Burnley,eng Premier League,22,1331,14.8,15,7,3,3,0,3,2,1,1,0,FW,2691c772,Rotational Player
2159,Marcus Ingvartsen,3,2020-2021,24,dk DEN,Union Berlin,de Bundesliga,30,1963,21.8,24,6,0,3,5,8,3,0,1,1,MFFW,271b8617,Rotational Player
2160,Pedro Porro,3,2022-2023,22,es ESP,Tottenham,eng Premier League,15,1131,12.6,13,2,2,3,3,6,3,0,0,0,DFMF,27d0a506,Rotational Player
2161,Pedro Porro,3,2023-2024,23,es ESP,Tottenham,eng Premier League,35,3089,34.3,35,0,1,3,7,10,3,0,0,0,DF,27d0a506,Rotational Player
2162,Lewis Dunk,3,2023-2024,31,eng ENG,Brighton,eng Premier League,33,2869,31.9,33,0,0,3,1,4,3,0,0,0,DF,282f75f3,Full Starter
2163,Nayef Aguerd,3,2020-2021,24,ma MAR,Rennes,fr Ligue 1,35,3147,35.0,35,0,0,3,1,4,3,0,0,0,DF,288e1e13,Full Starter
2164,César Montes,3,2022-2023,25,mx MEX,Espanyol,es La Liga,20,1590,17.7,18,2,0,3,0,3,3,0,0,0,DF,28e957d7,Rotational Player
2165,Nacho,3,2021-2022,31,es ESP,Real Madrid,es La Liga,28,1555,17.3,17,11,8,3,0,3,3,0,0,0,DF,2946f9a1,Rotational Player
2166,Simon Zoller,3,2022-2023,31,de GER,Bochum,de Bundesliga,27,1457,16.2,19,8,2,3,2,5,3,0,0,0,FW,29f7cfd9,Rotational Player
2167,Simon Zoller,3,2021-2022,30,de GER,Bochum,de Bundesliga,10,596,6.6,6,4,0,3,2,5,3,0,0,0,FW,29f7cfd9,Rotational Player
2168,Marten de Roon,3,2021-2022,30,nl NED,Atalanta,it Serie A,30,2548,28.3,28,2,1,3,0,3,3,0,0,0,MFDF,2a1beb34,Full Starter
2169,Marten de Roon,3,2022-2023,31,nl NED,Atalanta,it Serie A,35,2964,32.9,34,1,0,3,1,4,3,0,0,0,MF,2a1beb34,Full Starter
2170,Marten de Roon,3,2024-2025,33,nl NED,Atalanta,it Serie A,21,1800,20.0,20,1,0,3,1,4,3,0,0,0,MFDF,2a1beb34,Full Starter
2171,Grigoris Kastanos,3,2023-2024,25,cy CYP,Salernitana,it Serie A,26,1480,16.4,18,8,3,3,3,6,3,0,0,0,MFDF,2a82aa85,Rotational Player
2172,Roberto López,3,2020-2021,20,es ESP,Real Sociedad,es La Liga,17,505,5.6,4,13,19,3,0,3,3,0,0,0,MFFW,2a8c9f98,Bench Player
2173,Allan Saint-Maximin,3,2020-2021,23,fr FRA,Newcastle Utd,eng Premier League,25,1560,17.3,19,6,0,3,4,7,3,0,0,0,FWMF,2b16cb1a,Rotational Player
2174,Dilane Bakwa,3,2023-2024,20,fr FRA,Strasbourg,fr Ligue 1,31,2177,24.2,25,6,2,3,6,9,3,0,0,0,FWMF,2b5a35e5,Rotational Player
2175,Lucas Moura,3,2020-2021,27,br BRA,Tottenham,eng Premier League,30,1411,15.7,14,16,7,3,4,7,3,0,0,0,FWMF,2b622f01,Rotational Player
2176,Amir Richardson,3,2023-2024,21,ma MAR,Reims,fr Ligue 1,28,1352,15.0,14,14,3,3,1,4,3,0,0,0,MF,2b7cdb79,Rotational Player
2177,Cyril Ngonge,3,2022-2023,22,be BEL,Hellas Verona,it Serie A,14,745,8.3,9,5,4,3,1,4,3,0,0,0,MFFW,2b8360f1,Rotational Player
2178,Marko Pjaca,3,2021-2022,26,hr CRO,Torino,it Serie A,24,1149,12.8,13,11,7,3,0,3,3,0,0,0,MF,2c38b327,Rotational Player
2179,Marko Pjaca,3,2020-2021,25,hr CRO,Genoa,it Serie A,35,1418,15.8,15,20,0,3,2,5,3,0,0,0,FWMF,2c38b327,Rotational Player
2180,Akor Adams,3,2024-2025,24,ng NGA,Montpellier,fr Ligue 1,15,1075,11.9,13,2,1,3,1,4,3,0,0,0,FW,2ccd39ed,Rotational Player
2181,Armand Lauriente,3,2020-2021,21,fr FRA,Lorient,fr Ligue 1,29,1622,18.0,16,13,2,3,5,8,3,0,0,0,MFFW,2d22cea7,Full Starter
2182,Robin Gosens,3,2022-2023,28,de GER,Inter,it Serie A,32,1184,13.2,11,21,3,3,0,3,3,0,0,0,DF,2d970560,Rotational Player
2183,Carmona,3,2022-2023,20,es ESP,2 Teams,es La Liga,19,1116,12.4,13,6,5,3,1,4,3,0,0,0,MFDF,2dce876a,Rotational Player
2184,Andrew Robertson,3,2023-2024,29,sct SCO,Liverpool,eng Premier League,23,1693,18.8,18,5,0,3,2,5,3,0,0,0,DF,2e4f5f03,Rotational Player
2185,Andrew Robertson,3,2021-2022,27,sct SCO,Liverpool,eng Premier League,29,2537,28.2,29,0,4,3,10,13,3,0,0,0,DF,2e4f5f03,Rotational Player
2186,Morgan Rogers,3,2023-2024,21,eng ENG,Aston Villa,eng Premier League,11,638,7.1,8,3,3,3,1,4,3,0,0,0,MFFW,2e5915f1,Rotational Player
2187,Gianluca Lapadula,3,2023-2024,33,pe PER,Cagliari,it Serie A,23,1205,13.4,14,9,5,3,1,4,2,1,1,0,FW,2ead2809,Rotational Player
2188,Anthony Elanga,3,2024-2025,22,se SWE,Nott'ham Forest,eng Premier League,23,1369,15.2,17,6,0,3,5,8,3,0,0,0,FWMF,2fba6108,Rotational Player
2189,Stephy Mavididi,3,2024-2025,26,eng ENG,Leicester City,eng Premier League,21,1275,14.2,14,7,2,3,1,4,3,0,0,0,FW,30144daa,Rotational Player
2190,Mitchell Weiser,3,2024-2025,30,de GER,Werder Bremen,de Bundesliga,18,1611,17.9,18,0,0,3,5,8,3,0,0,0,DFMF,30c220c3,Rotational Player
2191,Mitchell Weiser,3,2023-2024,29,de GER,Werder Bremen,de Bundesliga,30,2636,29.3,30,0,1,3,7,10,3,0,0,0,DFMF,30c220c3,Rotational Player
2192,Milan Škriniar,3,2021-2022,26,sk SVK,Inter,it Serie A,35,3150,35.0,35,0,3,3,0,3,3,0,0,0,DF,30f5ffa9,Full Starter
2193,Milan Škriniar,3,2020-2021,25,sk SVK,Inter,it Serie A,32,2777,30.9,31,1,3,3,0,3,3,0,0,0,DF,30f5ffa9,Full Starter
2194,Laurent Abergel,3,2020-2021,27,fr FRA,Lorient,fr Ligue 1,38,2963,32.9,32,6,0,3,1,4,3,0,0,0,MF,31626657,Full Starter
2195,Folarin Balogun,3,2024-2025,23,us USA,Monaco,fr Ligue 1,7,469,5.2,6,1,1,3,0,3,3,0,0,0,FW,31822f8c,Rotational Player
2196,Zeki Çelik,3,2020-2021,23,tr TUR,Lille,fr Ligue 1,29,2381,26.5,28,1,1,3,2,5,3,0,0,0,DF,31a62dc7,Full Starter
2197,Sergi Guardiola,3,2022-2023,31,es ESP,2 Teams,es La Liga,31,1667,18.5,22,9,3,3,0,3,3,0,0,0,FW,32974271,Rotational Player
2198,Yunis Abdelhamid,3,2020-2021,32,ma MAR,Reims,fr Ligue 1,33,2889,32.1,33,0,0,3,0,3,3,0,0,0,DF,32c2d95f,Full Starter
2199,Abdoul Kader Bamba,3,2020-2021,26,fr FRA,Nantes,fr Ligue 1,29,917,10.2,6,23,1,3,1,4,3,0,1,1,FWMF,32f3d97e,Bench Player
2200,Jeffrey Schlupp,3,2022-2023,29,gh GHA,Crystal Palace,eng Premier League,34,2531,28.1,30,4,0,3,1,4,3,0,0,0,MFFW,3312f911,Rotational Player
2201,Sergi Roberto,3,2023-2024,31,es ESP,Barcelona,es La Liga,14,860,9.6,10,4,14,3,2,5,3,0,0,0,MFDF,335fa267,Rotational Player
2202,Marcelo Brozović,3,2022-2023,29,hr CRO,Inter,it Serie A,28,1770,19.7,19,9,0,3,5,8,3,0,0,0,MF,33b8d077,Rotational Player
2203,Valerio Verre,3,2020-2021,26,it ITA,Sampdoria,it Serie A,27,998,11.1,12,15,11,3,3,6,3,0,0,0,FWMF,33ecf462,Rotational Player
2204,Michael Amir Murillo,3,2023-2024,27,pa PAN,Marseille,fr Ligue 1,16,997,11.1,10,6,3,3,2,5,3,0,0,0,DF,349cae8f,Rotational Player
2205,Edon Zhegrova,3,2022-2023,23,xk KVX,Lille,fr Ligue 1,22,1056,11.7,11,11,8,3,4,7,3,0,0,0,FWMF,34a88e3e,Rotational Player
2206,Wilson Odobert,3,2023-2024,18,fr FRA,Burnley,eng Premier League,29,2098,23.3,25,4,4,3,2,5,3,0,0,0,MFFW,35516eac,Rotational Player
2207,Nicolò Fagioli,3,2022-2023,21,it ITA,Juventus,it Serie A,26,1520,16.9,17,9,8,3,3,6,3,0,0,0,MF,366be751,Rotational Player
2208,Aleksandr Golovin,3,2024-2025,28,ru RUS,Monaco,fr Ligue 1,15,1064,11.8,12,3,0,3,0,3,3,0,0,0,MFFW,3708e9fa,Rotational Player
2209,Aleksandr Golovin,3,2021-2022,25,ru RUS,Monaco,fr Ligue 1,27,1502,16.7,17,10,1,3,4,7,3,0,0,0,FWMF,3708e9fa,Rotational Player
2210,Denis Zakaria,3,2021-2022,24,ch SUI,2 Teams,2 Comps,25,1992,22.1,21,4,1,3,2,5,3,0,0,0,MFDF,384d58d9,Rotational Player
2211,Anthony Lozano,3,2023-2024,30,hn HON,2 Teams,es La Liga,19,864,9.6,10,9,15,3,0,3,3,0,0,0,MFFW,38699c72,Rotational Player
2212,Anthony Lozano,3,2020-2021,27,hn HON,Cádiz,es La Liga,29,1523,16.9,18,11,3,3,1,4,3,0,0,0,FW,38699c72,Rotational Player
2213,Aleksandar Mitrović,3,2020-2021,25,rs SRB,Fulham,eng Premier League,27,1402,15.6,13,14,3,3,3,6,2,1,2,1,FW,3925dbd6,Rotational Player
2214,Rasmus Kristensen,3,2022-2023,25,dk DEN,Leeds United,eng Premier League,26,1960,21.8,21,5,11,3,1,4,3,0,0,0,DF,39769cff,Rotational Player
2215,Ross Barkley,3,2024-2025,30,eng ENG,Aston Villa,eng Premier League,16,554,6.2,3,13,2,3,1,4,3,0,0,0,MF,3a24769f,Rotational Player
2216,Ross Barkley,3,2020-2021,26,eng ENG,2 Teams,eng Premier League,26,1573,17.5,18,8,5,3,1,4,3,0,0,0,MF,3a24769f,Rotational Player
2217,Vitinha,3,2024-2025,24,pt POR,Paris S-G,fr Ligue 1,16,1175,13.1,12,4,1,3,0,3,1,2,2,0,MF,3b029691,Rotational Player
2218,Riccardo Saponara,3,2021-2022,29,it ITA,Fiorentina,it Serie A,29,1284,14.3,13,16,7,3,3,6,3,0,0,0,FW,3bb7af3b,Rotational Player
2219,Pedro,3,2024-2025,37,es ESP,Lazio,it Serie A,15,539,6.0,4,11,5,3,0,3,3,0,0,0,FWMF,3ca7254a,Rotational Player
2220,Gaetano Letizia,3,2020-2021,30,it ITA,Benevento,it Serie A,24,1570,17.4,18,6,0,3,1,4,3,0,0,0,DF,3dd45b70,Rotational Player
2221,Samuel Mbangula,3,2024-2025,20,be BEL,Juventus,it Serie A,16,619,6.9,7,9,6,3,2,5,3,0,0,0,FW,3e25e70c,Bench Player
2222,Craig Dawson,3,2020-2021,30,eng ENG,West Ham,eng Premier League,22,1925,21.4,22,0,4,3,0,3,3,0,0,0,DF,3e9e06cb,Rotational Player
2223,Lebo Mothiba,3,2023-2024,27,za RSA,Strasbourg,fr Ligue 1,15,617,6.9,5,10,1,3,0,3,3,0,0,0,FW,3eaf8817,Bench Player
2224,Lebo Mothiba,3,2022-2023,26,za RSA,Strasbourg,fr Ligue 1,19,435,4.8,3,16,14,3,0,3,3,0,0,0,FWMF,3eaf8817,Bench Player
2225,Gelson Martins,3,2020-2021,25,pt POR,Monaco,fr Ligue 1,23,1551,17.2,20,3,2,3,2,5,3,0,0,0,MFFW,3ef0fa48,Rotational Player
2226,André Silva,3,2023-2024,27,pt POR,Real Sociedad,es La Liga,19,729,8.1,9,10,9,3,0,3,2,1,1,0,FW,3effaa34,Rotational Player
2227,Theodor Gebre Selassie,3,2020-2021,33,cz CZE,Werder Bremen,de Bundesliga,34,3032,33.7,34,0,0,3,1,4,3,0,0,0,DF,3f65898c,Full Starter
2228,Iñigo Martínez,3,2021-2022,30,es ESP,Athletic Club,es La Liga,27,2341,26.0,26,1,0,3,0,3,3,0,0,0,DF,3fc45c73,Full Starter
2229,Esteban Burgos,3,2020-2021,28,ar ARG,Eibar,es La Liga,14,1111,12.3,12,2,22,3,1,4,1,2,3,1,DF,40449bbd,Rotational Player
2230,Brahim Díaz,3,2024-2025,24,ma MAR,Real Madrid,es La Liga,16,774,8.6,8,8,0,3,2,5,3,0,0,0,FWMF,407feb71,Rotational Player
2231,Brahim Díaz,3,2021-2022,21,ma MAR,Milan,it Serie A,31,1855,20.6,25,6,4,3,3,6,3,0,0,0,MF,407feb71,Rotational Player
2232,Janni Serra,3,2021-2022,23,de GER,Arminia,de Bundesliga,26,1117,12.4,15,11,4,3,2,5,3,0,0,0,FW,40b58bfc,Rotational Player
2233,Samuel Gigot,3,2023-2024,29,fr FRA,Marseille,fr Ligue 1,21,1726,19.2,20,1,2,3,0,3,3,0,0,0,DF,41eebdf5,Rotational Player
2234,Keane Lewis-Potter,3,2023-2024,22,eng ENG,Brentford,eng Premier League,30,1441,16.0,15,15,3,3,1,4,3,0,0,0,FWDF,41f08ac8,Rotational Player
2235,Fernando,3,2020-2021,33,br BRA,Sevilla,es La Liga,31,2546,28.3,28,3,4,3,4,7,3,0,0,0,MF,41f32541,Full Starter
2236,Jonathan Ikone,3,2023-2024,25,fr FRA,Fiorentina,it Serie A,28,1682,18.7,18,10,4,3,1,4,3,0,0,0,FW,42eaa028,Rotational Player
2237,Ander Herrera,3,2021-2022,31,es ESP,Paris S-G,fr Ligue 1,19,1091,12.1,12,7,6,3,2,5,3,0,0,0,MF,436a9dd0,Rotational Player
2238,Divock Origi,3,2021-2022,26,be BEL,Liverpool,eng Premier League,7,133,1.5,0,7,11,3,0,3,3,0,0,0,FW,43a166b4,Bench Player
2239,Obite N'Dicka,3,2020-2021,20,ci CIV,Eint Frankfurt,de Bundesliga,23,2044,22.7,23,0,4,3,1,4,3,0,0,0,DF,441197b8,Full Starter
2240,Ridle Baku,3,2021-2022,23,de GER,Wolfsburg,de Bundesliga,34,2446,27.2,28,6,0,3,5,8,3,0,0,0,DFFW,442b56fa,Full Starter
2241,Danilo D'Ambrosio,3,2020-2021,31,it ITA,Inter,it Serie A,19,699,7.8,7,12,13,3,0,3,3,0,0,0,DF,44eb9093,Bench Player
2242,Jamie Vardy,3,2022-2023,35,eng ENG,Leicester City,eng Premier League,37,1857,20.6,19,18,1,3,4,7,3,0,1,1,FW,45963054,Rotational Player
2243,Joaquín Correa,3,2022-2023,27,ar ARG,Inter,it Serie A,26,950,10.6,12,14,3,3,1,4,3,0,0,0,FW,45b9b619,Rotational Player
2244,Jordi Alba,3,2020-2021,31,es ESP,Barcelona,es La Liga,35,3025,33.6,34,1,1,3,5,8,3,0,0,0,DFFW,4601e194,Full Starter
2245,Facundo Buonanotte,3,2023-2024,18,ar ARG,Brighton,eng Premier League,27,1364,15.2,17,10,6,3,1,4,3,0,0,0,FWMF,468a7a91,Rotational Player
2246,Charles Abi,3,2020-2021,20,fr FRA,Saint-Étienne,fr Ligue 1,24,912,10.1,9,15,2,3,2,5,3,0,0,0,FWMF,469d3d84,Bench Player
2247,Kevin Agudelo,3,2021-2022,22,co COL,2 Teams,it Serie A,23,1237,13.7,12,11,2,3,1,4,3,0,0,0,FWMF,46fa7204,Rotational Player
2248,Ibrahima Niane,3,2024-2025,25,sn SEN,Angers,fr Ligue 1,14,695,7.7,7,7,0,3,0,3,2,1,1,0,FW,46faabfa,Rotational Player
2249,Ibrahima Niane,3,2021-2022,22,sn SEN,Metz,fr Ligue 1,26,1582,17.6,20,6,8,3,1,4,2,1,1,0,FW,46faabfa,Rotational Player
2250,Adnan Januzaj,3,2021-2022,26,be BEL,Real Sociedad,es La Liga,33,1625,18.1,17,16,0,3,0,3,1,2,2,0,FWMF,4737cebe,Rotational Player
2251,Jason Denayer,3,2021-2022,26,be BEL,Lyon,fr Ligue 1,15,1002,11.1,12,3,2,3,0,3,3,0,0,0,DF,47af88b8,Rotational Player
2252,Nico Elvedi,3,2020-2021,23,ch SUI,Gladbach,de Bundesliga,29,2536,28.2,29,0,2,3,1,4,3,0,0,0,DF,48035304,Full Starter
2253,Nico Elvedi,3,2022-2023,25,ch SUI,Gladbach,de Bundesliga,32,2826,31.4,32,0,0,3,0,3,3,0,0,0,DF,48035304,Full Starter
2254,Abdelhamid Sabiri,3,2021-2022,24,ma MAR,Sampdoria,it Serie A,14,893,9.9,9,5,1,3,2,5,3,0,0,0,MFFW,4830e0af,Bench Player
2255,Jean-Eudes Aholou,3,2022-2023,28,ci CIV,Strasbourg,fr Ligue 1,30,1300,14.4,16,14,5,3,1,4,3,0,0,0,MF,48b28bfd,Rotational Player
2256,Joshua Kimmich,3,2021-2022,26,de GER,Bayern Munich,de Bundesliga,28,2474,27.5,28,0,0,3,9,12,3,0,0,0,MF,49296448,Full Starter
2257,Ashley Westwood,3,2020-2021,30,eng ENG,Burnley,eng Premier League,38,3410,37.9,38,0,0,3,3,6,3,0,0,0,MF,495945ef,Full Starter
2258,Isaac Palazón Camacho,3,2024-2025,29,es ESP,Rayo Vallecano,es La Liga,21,1301,14.5,15,6,0,3,3,6,3,0,0,0,FWMF,49dbab27,Full Starter
2259,Antonio Nusa,3,2024-2025,19,no NOR,RB Leipzig,de Bundesliga,19,1323,14.7,14,5,0,3,3,6,3,0,0,0,MFDF,4ab12002,Rotational Player
2260,Alessandro Buongiorno,3,2023-2024,24,it ITA,Torino,it Serie A,29,2527,28.1,29,0,1,3,0,3,3,0,0,0,DF,4ae67f27,Full Starter
2261,Amir Rrahmani,3,2023-2024,29,xk KVX,Napoli,it Serie A,30,2600,28.9,30,0,3,3,0,3,3,0,0,0,DF,4b3e1a38,Full Starter
2262,Neal Maupay,3,2024-2025,27,fr FRA,2 Teams,2 Comps,15,839,9.3,12,3,3,3,4,7,3,0,0,0,FWMF,4bcf39f6,Rotational Player
2263,Jon Guridi,3,2023-2024,28,es ESP,Alavés,es La Liga,36,2678,29.8,34,2,1,3,4,7,3,0,0,0,MF,4c0a6a48,Full Starter
2264,Justin Kluivert,3,2020-2021,21,nl NED,2 Teams,2 Comps,21,832,9.2,8,13,8,3,1,4,3,0,0,0,MF,4c3a6744,Rotational Player
2265,Jacob Bruun Larsen,3,2024-2025,25,dk DEN,2 Teams,de Bundesliga,16,593,6.6,5,11,3,3,2,5,3,0,0,0,FWMF,4e204552,Rotational Player
2266,Suso,3,2020-2021,26,es ESP,Sevilla,es La Liga,34,2210,24.6,28,6,0,3,4,7,3,0,0,0,FW,4e219ad2,Full Starter
2267,Chris Wood,3,2022-2023,30,nz NZL,2 Teams,eng Premier League,25,818,9.1,9,16,1,3,0,3,2,1,1,0,FW,4e9a0555,Rotational Player
2268,Aurélien Tchouaméni,3,2023-2024,23,fr FRA,Real Madrid,es La Liga,27,1987,22.1,22,5,1,3,1,4,3,0,0,0,MFDF,4f255115,Full Starter
2269,Aurélien Tchouaméni,3,2021-2022,21,fr FRA,Monaco,fr Ligue 1,35,2929,32.5,33,2,0,3,2,5,3,0,0,0,MF,4f255115,Full Starter
2270,Curtis Jones,3,2024-2025,23,eng ENG,Liverpool,eng Premier League,18,896,10.0,10,8,1,3,2,5,3,0,0,0,MF,4fb9c88f,Rotational Player
2271,Curtis Jones,3,2022-2023,21,eng ENG,Liverpool,eng Premier League,18,1035,11.5,12,6,5,3,1,4,3,0,0,0,MF,4fb9c88f,Rotational Player
2272,Karim Adeyemi,3,2023-2024,21,de GER,Dortmund,de Bundesliga,21,913,10.1,10,11,3,3,1,4,3,0,0,0,FWMF,501055d8,Rotational Player
2273,Stéphane Bahoken,3,2021-2022,29,cm CMR,Angers,fr Ligue 1,29,1099,12.2,12,17,2,3,1,4,3,0,0,0,FW,5046b7d4,Rotational Player
2274,Yangel Herrera,3,2020-2021,22,ve VEN,Granada,es La Liga,32,2310,25.7,25,7,0,3,1,4,3,0,0,0,MF,5083a734,Full Starter
2275,Keita Baldé,3,2021-2022,26,sn SEN,Cagliari,it Serie A,26,1229,13.7,14,12,3,3,1,4,3,0,0,0,FW,509a4ccb,Rotational Player
2276,Darko Lazović,3,2020-2021,29,rs SRB,Hellas Verona,it Serie A,32,2503,27.8,27,5,1,3,6,9,3,0,0,0,DFMF,5128bde4,Full Starter
2277,Darko Lazović,3,2023-2024,32,rs SRB,Hellas Verona,it Serie A,32,1928,21.4,22,10,0,3,2,5,2,1,1,0,FWMF,5128bde4,Full Starter
2278,Thilo Kehrer,3,2024-2025,27,de GER,Monaco,fr Ligue 1,16,1440,16.0,16,0,3,3,0,3,3,0,0,0,DF,51dbeea9,Rotational Player
2279,Jonathan Clauss,3,2020-2021,27,fr FRA,Lens,fr Ligue 1,33,2521,28.0,30,3,4,3,6,9,3,0,0,0,DF,5219ab4a,Full Starter
2280,Jonathan Clauss,3,2023-2024,30,fr FRA,Marseille,fr Ligue 1,27,2068,23.0,25,2,1,3,4,7,3,0,0,0,DF,5219ab4a,Full Starter
2281,Thomas Partey,3,2022-2023,29,gh GHA,Arsenal,eng Premier League,33,2483,27.6,28,5,0,3,0,3,3,0,0,0,MF,529f49ab,Full Starter
2282,Ante Rebić,3,2022-2023,28,hr CRO,Milan,it Serie A,23,980,10.9,10,13,5,3,2,5,3,0,0,0,FWMF,536cebe5,Rotational Player
2283,Yeremi Pino,3,2020-2021,17,es ESP,Villarreal,es La Liga,24,797,8.9,6,18,5,3,1,4,3,0,0,0,FWMF,540ec57b,Rotational Player
2284,Trevoh Chalobah,3,2024-2025,25,eng ENG,2 Teams,eng Premier League,14,1240,13.8,14,0,2,3,1,4,3,0,0,0,DF,5515376c,Rotational Player
2285,Trevoh Chalobah,3,2021-2022,22,eng ENG,Chelsea,eng Premier League,20,1449,16.1,17,3,13,3,1,4,3,0,0,0,DF,5515376c,Rotational Player
2286,Arne Engels,3,2023-2024,19,be BEL,Augsburg,de Bundesliga,32,1405,15.6,13,19,0,3,2,5,3,0,0,0,MFDF,554bcc91,Rotational Player
2287,Mario Hermoso,3,2022-2023,27,es ESP,Atlético Madrid,es La Liga,26,2110,23.4,24,2,10,3,2,5,3,0,0,0,DF,555f3a0b,Rotational Player
2288,Jubal,3,2022-2023,28,br BRA,Auxerre,fr Ligue 1,37,3217,35.7,35,2,1,3,1,4,2,1,1,0,DF,56ae428b,Full Starter
2289,Youri Tielemans,3,2022-2023,25,be BEL,Leicester City,eng Premier League,31,2344,26.0,27,4,0,3,2,5,2,1,2,1,MF,56f7a928,Full Starter
2290,Gustav Isaksen,3,2023-2024,22,dk DEN,Lazio,it Serie A,28,1074,11.9,12,16,8,3,1,4,3,0,0,0,FW,5715bb71,Rotational Player
2291,Eldor Shomurodov,3,2023-2024,28,uz UZB,Cagliari,it Serie A,22,936,10.4,10,12,5,3,3,6,3,0,0,0,FWMF,57469b2d,Rotational Player
2292,Eldor Shomurodov,3,2021-2022,26,uz UZB,Roma,it Serie A,28,784,8.7,5,23,9,3,4,7,3,0,0,0,FWMF,57469b2d,Rotational Player
2293,Jude Bellingham,3,2021-2022,18,eng ENG,Dortmund,de Bundesliga,32,2790,31.0,32,0,0,3,8,11,3,0,0,0,MF,57d88cf9,Full Starter
2294,Nikola Dovedan,3,2023-2024,29,at AUT,Heidenheim,de Bundesliga,21,656,7.3,5,16,9,3,1,4,3,0,0,0,MFFW,57d9f511,Bench Player
2295,Óliver Torres,3,2022-2023,27,es ESP,Sevilla,es La Liga,32,2137,23.7,27,5,6,3,1,4,3,0,0,0,MFFW,58a9a4d9,Full Starter
2296,Faris Pemi Moumbagna,3,2023-2024,23,cm CMR,Marseille,fr Ligue 1,13,547,6.1,5,8,1,3,1,4,3,0,0,0,FW,58aae0a9,Bench Player
2297,Mauro Arambarri,3,2020-2021,24,uy URU,Getafe,es La Liga,34,2983,33.1,33,1,2,3,0,3,3,0,0,0,MF,58afe001,Rotational Player
2298,David Costa,3,2021-2022,20,pt POR,Lens,fr Ligue 1,33,1464,16.3,16,17,5,3,5,8,3,0,0,0,MFFW,59948ef7,Rotational Player
2299,Dominic Calvert-Lewin,3,2024-2025,27,eng ENG,Everton,eng Premier League,22,1574,17.5,19,3,0,3,1,4,3,0,0,0,FW,59e6e5bf,Rotational Player
2300,Augustine Boakye,3,2024-2025,23,gh GHA,Saint-Étienne,fr Ligue 1,12,569,6.3,6,6,1,3,0,3,3,0,0,0,MFFW,59e9edb5,Bench Player
2301,Saïd Benrahma,3,2023-2024,27,dz ALG,2 Teams,2 Comps,25,1390,15.4,15,10,8,3,4,7,3,0,1,1,FWMF,5a04fd92,Rotational Player
2302,Federico Baschirotto,3,2022-2023,25,it ITA,Lecce,it Serie A,37,3330,37.0,37,0,0,3,0,3,3,0,0,0,DF,5a08ee41,Full Starter
2303,Moi Gómez,3,2023-2024,29,es ESP,Osasuna,es La Liga,28,2006,22.3,23,5,5,3,0,3,3,0,0,0,MFFW,5a626448,Full Starter
2304,Moi Gómez,3,2022-2023,28,es ESP,Osasuna,es La Liga,33,2453,27.3,28,5,1,3,2,5,3,0,0,0,MFFW,5a626448,Full Starter
2305,Étienne Capoue,3,2022-2023,34,fr FRA,Villarreal,es La Liga,28,1955,21.7,22,6,1,3,0,3,3,0,0,0,MF,5acc4a10,Rotational Player
2306,Santi Comesaña,3,2022-2023,25,es ESP,Rayo Vallecano,es La Liga,35,2451,27.2,29,6,0,3,2,5,3,0,0,0,MF,5ae499d0,Full Starter
2307,Lilian Brassier,3,2023-2024,23,fr FRA,Brest,fr Ligue 1,30,2677,29.7,30,0,0,3,0,3,3,0,0,0,DF,5b146df3,Full Starter
2308,Gaël Kakuta,3,2021-2022,30,cd COD,Lens,fr Ligue 1,29,1673,18.6,20,9,1,3,2,5,2,1,1,0,MFFW,5b1bf5e3,Rotational Player
2309,Myron Boadu,3,2022-2023,21,nl NED,Monaco,fr Ligue 1,12,295,3.3,3,9,13,3,0,3,3,0,0,0,FW,5b479568,Bench Player
2310,Hugo Ekitike,3,2022-2023,20,fr FRA,Paris S-G,fr Ligue 1,25,1155,12.8,12,13,12,3,4,7,3,0,0,0,FW,5b92d896,Rotational Player
2311,Francesco Caputo,3,2023-2024,35,it ITA,Empoli,it Serie A,20,1268,14.1,15,5,6,3,0,3,2,1,1,0,FW,5bd72174,Rotational Player
2312,Marcus Tavernier,3,2023-2024,24,eng ENG,Bournemouth,eng Premier League,30,2118,23.5,25,5,0,3,4,7,3,0,0,0,FW,5c0da4a4,Rotational Player
2313,Kevin Paredes,3,2023-2024,20,us USA,Wolfsburg,de Bundesliga,28,1432,15.9,15,13,3,3,0,3,3,0,0,0,FWMF,5c50fdbc,Rotational Player
2314,Rubén García,3,2020-2021,27,es ESP,Osasuna,es La Liga,37,2718,30.2,33,4,0,3,5,8,2,1,1,0,MFFW,5c96b017,Full Starter
2315,Rubén García,3,2023-2024,30,es ESP,Osasuna,es La Liga,30,1547,17.2,19,11,6,3,2,5,3,0,0,0,FWMF,5c96b017,Full Starter
2316,Tanguy Ndombele,3,2020-2021,23,fr FRA,Tottenham,eng Premier League,33,2091,23.2,28,5,3,3,2,5,3,0,0,0,MF,5cdddffa,Full Starter
2317,Adrien Truffert,3,2021-2022,19,fr FRA,Rennes,fr Ligue 1,30,1639,18.2,18,12,6,3,2,5,3,0,0,0,DF,5d0e0a1f,Rotational Player
2318,Patrik Schick,3,2022-2023,26,cz CZE,Leverkusen,de Bundesliga,14,941,10.5,10,4,0,3,1,4,3,0,0,0,FW,5d4f7d61,Rotational Player
2319,Maximilian Beier,3,2024-2025,21,de GER,Dortmund,de Bundesliga,18,945,10.5,10,8,1,3,2,5,3,0,0,0,FWMF,5db45ee5,Rotational Player
2320,Matteo Politano,3,2022-2023,28,it ITA,Napoli,it Serie A,27,1166,13.0,14,13,6,3,3,6,1,2,3,1,FW,5e861944,Rotational Player
2321,Matteo Politano,3,2021-2022,27,it ITA,Napoli,it Serie A,33,1650,18.3,20,13,2,3,4,7,3,0,0,0,FW,5e861944,Rotational Player
2322,Iliman Ndiaye,3,2023-2024,23,sn SEN,Marseille,fr Ligue 1,30,1618,18.0,19,11,0,3,3,6,3,0,0,0,FWMF,5ed97752,Rotational Player
2323,Harold Moukoudi,3,2020-2021,22,cm CMR,Saint-Étienne,fr Ligue 1,26,2276,25.3,26,0,3,3,1,4,3,0,0,0,DF,5f26e0c5,Full Starter
2324,Moses Simon,3,2023-2024,28,ng NGA,Nantes,fr Ligue 1,22,1788,19.9,21,1,0,3,5,8,2,1,1,0,FWMF,5f3eaaf5,Rotational Player
2325,Gleison Bremer,3,2023-2024,26,br BRA,Juventus,it Serie A,36,3233,35.9,36,0,1,3,0,3,3,0,0,0,DF,5fd5ed86,Full Starter
2326,Gleison Bremer,3,2021-2022,24,br BRA,Torino,it Serie A,33,2890,32.1,33,0,1,3,1,4,3,0,0,0,DF,5fd5ed86,Full Starter
2327,Enzo Fernández,3,2024-2025,23,ar ARG,Chelsea,eng Premier League,21,1602,17.8,17,4,0,3,4,7,3,0,0,0,MF,5ff4ab71,Rotational Player
2328,Enzo Fernández,3,2023-2024,22,ar ARG,Chelsea,eng Premier League,28,2209,24.5,26,2,0,3,2,5,2,1,2,1,MF,5ff4ab71,Rotational Player
2329,Ignacio Pussetto,3,2020-2021,24,ar ARG,Udinese,it Serie A,11,754,8.4,9,2,0,3,1,4,3,0,0,0,FW,62437b4f,Rotational Player
2330,Kevin Volland,3,2022-2023,30,de GER,Monaco,fr Ligue 1,17,639,7.1,7,10,5,3,2,5,3,0,0,0,FWMF,64f69877,Rotational Player
2331,Kevin Volland,3,2023-2024,31,de GER,2 Teams,2 Comps,26,1345,14.9,17,9,2,3,4,7,1,2,3,1,FWMF,64f69877,Rotational Player
2332,Rodrigo Riquelme,3,2023-2024,23,es ESP,Atlético Madrid,es La Liga,34,1528,17.0,17,17,4,3,5,8,3,0,0,0,DFMF,65154df0,Rotational Player
2333,Abdou Harroui,3,2023-2024,25,nl NED,Frosinone,it Serie A,18,1019,11.3,13,5,2,3,3,6,2,1,1,0,MFFW,65fd099c,Rotational Player
2334,Andreas Pereira,3,2023-2024,27,br BRA,Fulham,eng Premier League,37,2613,29.0,34,3,1,3,7,10,3,0,0,0,MF,6639e500,Full Starter
2335,Gabriel Magalhães,3,2024-2025,26,br BRA,Arsenal,eng Premier League,21,1808,20.1,21,0,0,3,1,4,3,0,0,0,DF,67ac5bb8,Full Starter
2336,Gabriel Magalhães,3,2022-2023,24,br BRA,Arsenal,eng Premier League,38,3409,37.9,38,0,0,3,0,3,3,0,0,0,DF,67ac5bb8,Full Starter
2337,Josip Iličić,3,2021-2022,33,si SVN,Atalanta,it Serie A,20,841,9.3,8,12,1,3,3,6,3,0,1,1,MFFW,68252d6d,Rotational Player
2338,Umar Sadiq,3,2023-2024,26,ng NGA,Real Sociedad,es La Liga,26,1077,12.0,12,14,10,3,1,4,3,0,0,0,FW,686cbe7d,Bench Player
2339,Umar Sadiq,3,2022-2023,25,ng NGA,2 Teams,es La Liga,5,322,3.6,4,1,0,3,0,3,3,0,0,0,FW,686cbe7d,Bench Player
2340,Pedro Chirivella,3,2021-2022,24,es ESP,Nantes,fr Ligue 1,31,2637,29.3,31,0,0,3,1,4,3,0,0,0,MF,68a26d51,Full Starter
2341,Nicolò Barella,3,2024-2025,27,it ITA,Inter,it Serie A,18,1389,15.4,17,1,1,3,5,8,3,0,0,0,MF,6928979a,Full Starter
2342,Nicolò Barella,3,2021-2022,24,it ITA,Inter,it Serie A,36,2913,32.4,36,0,1,3,11,14,3,0,0,0,MF,6928979a,Full Starter
2343,Nicolò Barella,3,2020-2021,23,it ITA,Inter,it Serie A,36,2896,32.2,32,4,1,3,7,10,3,0,0,0,MF,6928979a,Full Starter
2344,Steffen Tigges,3,2023-2024,25,de GER,Köln,de Bundesliga,25,727,8.1,6,19,4,3,0,3,3,0,0,0,FW,6b8887c2,Bench Player
2345,Steffen Tigges,3,2021-2022,23,de GER,Dortmund,de Bundesliga,9,112,1.2,0,9,7,3,0,3,3,0,0,0,FWMF,6b8887c2,Bench Player
2346,Andre-Frank Zambo Anguissa,3,2022-2023,26,cm CMR,Napoli,it Serie A,36,3050,33.9,36,0,0,3,5,8,3,0,0,0,MF,6bb2c084,Full Starter
2347,Yann Gboho,3,2023-2024,22,fr FRA,Toulouse,fr Ligue 1,16,1193,13.3,13,3,0,3,2,5,3,0,0,0,MFFW,6be41a31,Rotational Player
2348,Milot Rashica,3,2020-2021,24,xk KVX,Werder Bremen,de Bundesliga,24,1462,16.2,14,10,1,3,2,5,2,1,1,0,FWMF,6c6a3300,Rotational Player
2349,Abel Ruiz,3,2024-2025,24,es ESP,Girona,es La Liga,15,969,10.8,12,3,2,3,0,3,2,1,1,0,FW,6cbf8d0d,Rotational Player
2350,Toni Kroos,3,2020-2021,30,de GER,Real Madrid,es La Liga,28,2117,23.5,24,4,3,3,10,13,3,0,0,0,MF,6ce1f46f,Rotational Player
2351,Youssoufa Moukoko,3,2020-2021,15,de GER,Dortmund,de Bundesliga,14,422,4.7,2,12,4,3,0,3,3,0,0,0,FWMF,6ce43701,Bench Player
2352,Habib Diarra,3,2023-2024,19,sn SEN,Strasbourg,fr Ligue 1,31,2305,25.6,28,3,0,3,1,4,2,1,1,0,MFFW,6d0fe035,Rotational Player
2353,Habib Diarra,3,2022-2023,18,sn SEN,Strasbourg,fr Ligue 1,29,1626,18.1,18,11,6,3,2,5,3,0,0,0,MFFW,6d0fe035,Rotational Player
2354,Romain Perraud,3,2020-2021,22,fr FRA,Brest,fr Ligue 1,36,3140,34.9,35,1,0,3,7,10,3,0,0,0,DF,6dfd8f05,Full Starter
2355,Florian Lejeune,3,2023-2024,32,fr FRA,Rayo Vallecano,es La Liga,37,3327,37.0,37,0,0,3,1,4,3,0,0,0,DF,6eaed4eb,Full Starter
2356,Ruben Vargas,3,2022-2023,23,ch SUI,Augsburg,de Bundesliga,23,1130,12.6,13,10,3,3,4,7,3,0,0,0,MFFW,6ecbddf6,Rotational Player
2357,Hernani,3,2024-2025,30,br BRA,Parma,it Serie A,15,943,10.5,12,3,1,3,1,4,0,3,3,0,MF,6f5ead86,Rotational Player
2358,Marcus Thuram,3,2021-2022,23,fr FRA,Gladbach,de Bundesliga,21,979,10.9,9,12,1,3,0,3,3,0,0,0,FW,6f8cd6d0,Rotational Player
2359,Jaka Bijol,3,2022-2023,23,si SVN,Udinese,it Serie A,32,2728,30.3,32,0,3,3,2,5,3,0,0,0,DF,6fdac234,Full Starter
2360,Myziane Maolida,3,2020-2021,21,km COM,Nice,fr Ligue 1,19,1077,12.0,11,8,4,3,1,4,3,0,0,0,FWMF,706a60e1,Rotational Player
2361,Janik Haberer,3,2021-2022,27,de GER,Freiburg,de Bundesliga,26,818,9.1,7,19,8,3,0,3,3,0,0,0,MF,70dcf94d,Rotational Player
2362,Dani Rodríguez,3,2024-2025,36,es ESP,Mallorca,es La Liga,21,1160,12.9,14,7,0,3,4,7,3,0,0,0,MFFW,70f8e0bd,Rotational Player
2363,Dani Rodríguez,3,2022-2023,34,es ESP,Mallorca,es La Liga,35,2100,23.3,26,9,0,3,6,9,3,0,0,0,MF,70f8e0bd,Rotational Player
2364,Dani Rodríguez,3,2021-2022,33,es ESP,Mallorca,es La Liga,36,2832,31.5,33,3,1,3,3,6,3,0,0,0,MFFW,70f8e0bd,Rotational Player
2365,Vinicius Júnior,3,2020-2021,20,br BRA,Real Madrid,es La Liga,35,1969,21.9,22,13,2,3,3,6,3,0,0,0,FW,7111d552,Rotational Player
2366,Niko Gießelmann,3,2021-2022,29,de GER,Union Berlin,de Bundesliga,28,2083,23.1,25,3,3,3,6,9,3,0,0,0,DFFW,7242b495,Rotational Player
2367,Idrissa Gana Gueye,3,2021-2022,31,sn SEN,Paris S-G,fr Ligue 1,26,1641,18.2,18,8,3,3,1,4,3,0,0,0,MF,72c812f3,Rotational Player
2368,Jurgen Ekkelenkamp,3,2021-2022,21,nl NED,Hertha BSC,de Bundesliga,21,718,8.0,6,15,6,3,0,3,3,0,0,0,MFFW,73d6a176,Bench Player
2369,Daniel Parejo,3,2023-2024,34,es ESP,Villarreal,es La Liga,33,2580,28.7,29,4,1,3,5,8,0,3,3,0,MF,7460ca0d,Full Starter
2370,Daniel Parejo,3,2024-2025,35,es ESP,Villarreal,es La Liga,19,1329,14.8,16,3,0,3,1,4,2,1,2,1,MF,7460ca0d,Full Starter
2371,Daniel Parejo,3,2020-2021,31,es ESP,Villarreal,es La Liga,36,3112,34.6,36,0,0,3,5,8,3,0,0,0,MF,7460ca0d,Full Starter
2372,Daniel Parejo,3,2022-2023,33,es ESP,Villarreal,es La Liga,37,3285,36.5,37,0,0,3,4,7,1,2,4,2,MF,7460ca0d,Full Starter
2373,Kaoru Mitoma,3,2023-2024,26,jp JPN,Brighton,eng Premier League,19,1486,16.5,15,4,0,3,4,7,3,0,0,0,FW,74618572,Rotational Player
2374,Angelo Ogbonna,3,2020-2021,32,it ITA,West Ham,eng Premier League,28,2492,27.7,28,0,1,3,0,3,3,0,0,0,DF,74b2cd7e,Full Starter
2375,Opa Nguette,3,2020-2021,26,sn SEN,Metz,fr Ligue 1,16,1132,12.6,13,3,0,3,1,4,3,0,1,1,FWMF,75a63397,Rotational Player
2376,Roberto Pereyra,3,2021-2022,30,ar ARG,Udinese,it Serie A,24,1794,19.9,22,2,1,3,5,8,2,1,2,1,MFFW,75f2c59f,Full Starter
2377,Philipp Förster,3,2020-2021,25,de GER,Stuttgart,de Bundesliga,25,1509,16.8,17,8,3,3,1,4,3,0,1,1,MF,76fa965f,Rotational Player
2378,Philipp Förster,3,2022-2023,27,de GER,Bochum,de Bundesliga,25,1309,14.5,15,10,6,3,7,10,3,0,0,0,MF,76fa965f,Rotational Player
2379,Kenny Lala,3,2020-2021,28,mg MAD,Strasbourg,fr Ligue 1,21,1834,20.4,21,0,0,3,2,5,0,3,3,0,DF,770d7eb8,Rotational Player
2380,Francisco Trincão,3,2020-2021,20,pt POR,Barcelona,es La Liga,28,706,7.8,3,25,10,3,2,5,3,0,0,0,FWMF,77e39b04,Bench Player
2381,Léo Scienza,3,2024-2025,25,br BRA,Heidenheim,de Bundesliga,17,837,9.3,11,6,1,3,2,5,3,0,0,0,FWMF,79064bc9,Rotational Player
2382,Pierrick Capelle,3,2020-2021,33,fr FRA,Angers,fr Ligue 1,35,2053,22.8,24,11,1,3,3,6,3,0,0,0,MFDF,79b2399c,Rotational Player
2383,Pavel Kadeřábek,3,2023-2024,31,cz CZE,Hoffenheim,de Bundesliga,29,2412,26.8,28,1,0,3,4,7,3,0,0,0,DFFW,79c90e45,Full Starter
2384,Alejandro Garnacho,3,2024-2025,20,ar ARG,Manchester Utd,eng Premier League,22,1231,13.7,12,10,0,3,1,4,3,0,0,0,FWMF,7aa8adfe,Rotational Player
2385,Alejandro Garnacho,3,2022-2023,18,ar ARG,Manchester Utd,eng Premier League,19,569,6.3,5,14,9,3,2,5,3,0,0,0,FWMF,7aa8adfe,Rotational Player
2386,Bryan Gil,3,2024-2025,23,es ESP,Girona,es La Liga,19,1308,14.5,16,3,0,3,3,6,3,0,0,0,FWMF,7b5ab7f2,Rotational Player
2387,Sepp van den Berg,3,2023-2024,21,nl NED,Mainz 05,de Bundesliga,33,2839,31.5,31,2,0,3,0,3,3,0,0,0,DF,7bf9400b,Full Starter
2388,Rony Lopes,3,2020-2021,24,pt POR,Nice,fr Ligue 1,28,1783,19.8,23,5,2,3,1,4,3,0,0,0,FWMF,7c2965bb,Full Starter
2389,Aimar Oroz,3,2022-2023,20,es ESP,Osasuna,es La Liga,31,2013,22.4,23,8,2,3,6,9,2,1,1,0,MFFW,7c363088,Rotational Player
2390,Christopher Nkunku,3,2023-2024,25,fr FRA,Chelsea,eng Premier League,11,443,4.9,2,9,1,3,0,3,3,0,0,0,FWMF,7c56da38,Rotational Player
2391,Sambou Soumano,3,2021-2022,20,sn SEN,Lorient,fr Ligue 1,21,447,5.0,4,17,3,3,0,3,3,0,0,0,FWMF,7cc00776,Bench Player
2392,Destiny Udogie,3,2022-2023,19,it ITA,Udinese,it Serie A,33,2704,30.0,31,2,0,3,4,7,3,0,0,0,DF,7cd520e8,Full Starter
2393,David Raum,3,2021-2022,23,de GER,Hoffenheim,de Bundesliga,32,2757,30.6,31,1,0,3,11,14,3,0,0,0,DFFW,7d450ed3,Full Starter
2394,Florent Mollet,3,2020-2021,28,fr FRA,Montpellier,fr Ligue 1,34,2355,26.2,30,4,0,3,5,8,3,0,0,0,MF,7e82a78f,Full Starter
2395,Josip Stanišić,3,2023-2024,23,hr CRO,Leverkusen,de Bundesliga,20,1261,14.0,13,7,12,3,1,4,3,0,0,0,DF,7ed08d5c,Rotational Player
2396,Răzvan Marin,3,2024-2025,28,ro ROU,Cagliari,it Serie A,21,1060,11.8,11,10,1,3,2,5,1,2,2,0,MF,7fac99d4,Rotational Player
2397,Răzvan Marin,3,2020-2021,24,ro ROU,Cagliari,it Serie A,37,2965,32.9,35,2,0,3,6,9,3,0,0,0,MF,7fac99d4,Rotational Player
2398,Daniel Podence,3,2020-2021,24,pt POR,Wolves,eng Premier League,24,1661,18.5,22,2,0,3,2,5,3,0,0,0,MFFW,7fcc71d8,Rotational Player
2399,Daniel Maldini,3,2024-2025,22,it ITA,Monza,it Serie A,19,1239,13.8,15,4,0,3,0,3,3,0,0,0,MFFW,801831fe,Rotational Player
2400,Harrison Reed,3,2022-2023,27,eng ENG,Fulham,eng Premier League,37,2866,31.8,35,2,0,3,4,7,3,0,0,0,MF,803ae100,Full Starter
2401,Simeon Nwankwo,3,2023-2024,31,ng NGA,Salernitana,it Serie A,15,686,7.6,6,9,10,3,0,3,3,0,0,0,FW,80dbbd10,Rotational Player
2402,Sebastian Rudy,3,2021-2022,31,de GER,Hoffenheim,de Bundesliga,21,773,8.6,7,14,4,3,1,4,3,0,0,0,MF,80f36c88,Bench Player
2403,Marcos Acuña,3,2022-2023,30,ar ARG,Sevilla,es La Liga,30,1912,21.2,21,9,0,3,2,5,3,0,0,0,DF,81442ecb,Rotational Player
2404,Marc-Oliver Kempf,3,2021-2022,26,de GER,2 Teams,de Bundesliga,24,1891,21.0,22,2,2,3,1,4,3,0,0,0,DF,815c314f,Rotational Player
2405,Ayoze Pérez,3,2022-2023,29,es ESP,2 Teams,2 Comps,27,1768,19.6,20,7,10,3,2,5,3,0,0,0,MFFW,819aa8e7,Rotational Player
2406,Valentin Mihaila,3,2020-2021,20,ro ROU,Parma,it Serie A,16,698,7.8,4,12,2,3,0,3,3,0,0,0,FWMF,81a4c239,Bench Player
2407,Fernando Niño,3,2020-2021,19,es ESP,Villarreal,es La Liga,17,593,6.6,8,9,19,3,0,3,3,0,0,0,FW,81d5c497,Bench Player
2408,Gerard Moreno,3,2024-2025,32,es ESP,Villarreal,es La Liga,11,539,6.0,5,6,1,3,1,4,0,3,3,0,FW,81f0781e,Rotational Player
2409,Malick Fofana,3,2024-2025,19,be BEL,Lyon,fr Ligue 1,18,1004,11.2,10,8,0,3,3,6,3,0,0,0,FWMF,8236f673,Bench Player
2410,Malick Fofana,3,2023-2024,18,be BEL,Lyon,fr Ligue 1,17,559,6.2,4,13,0,3,0,3,3,0,0,0,FW,8236f673,Bench Player
2411,Bruno Guimarães,3,2020-2021,22,br BRA,Lyon,fr Ligue 1,33,1754,19.5,21,12,2,3,1,4,2,1,1,0,MF,82518f62,Full Starter
2412,Pablo Fornals,3,2023-2024,27,es ESP,2 Teams,2 Comps,30,1574,17.5,18,12,6,3,2,5,3,0,0,0,MFFW,82927de4,Rotational Player
2413,Pablo Fornals,3,2022-2023,26,es ESP,West Ham,eng Premier League,32,1503,16.7,17,15,6,3,1,4,3,0,0,0,FWMF,82927de4,Rotational Player
2414,Roger Ibanez,3,2022-2023,23,br BRA,Roma,it Serie A,33,2796,31.1,32,1,3,3,0,3,3,0,0,0,DF,82efe6fa,Full Starter
2415,Roger Ibanez,3,2021-2022,22,br BRA,Roma,it Serie A,34,2889,32.1,32,2,1,3,0,3,3,0,0,0,DF,82efe6fa,Full Starter
2416,Thomas Delaine,3,2020-2021,28,fr FRA,Metz,fr Ligue 1,24,1779,19.8,19,5,11,3,2,5,3,0,0,0,DFFW,8332db56,Rotational Player
2417,Sandro Ramírez,3,2021-2022,26,es ESP,Getafe,es La Liga,29,1462,16.2,19,10,1,3,0,3,3,0,0,0,FW,833fb62e,Rotational Player
2418,Tomáš Suslov,3,2023-2024,21,sk SVK,Hellas Verona,it Serie A,32,2092,23.2,23,9,2,3,5,8,2,1,1,0,MFFW,83fe71b8,Rotational Player
2419,Juanmi,3,2023-2024,30,es ESP,Cádiz,es La Liga,16,873,9.7,9,7,0,3,1,4,3,0,0,0,FW,84399660,Rotational Player
2420,Vitaly Janelt,3,2022-2023,24,de GER,Brentford,eng Premier League,35,2208,24.5,24,11,0,3,1,4,3,0,0,0,MFDF,8449d35e,Full Starter
2421,Lee Kang-in,3,2023-2024,22,kr KOR,Paris S-G,fr Ligue 1,23,1464,16.3,18,5,1,3,4,7,3,0,0,0,FWMF,8455ad90,Rotational Player
2422,Thomas Monconduit,3,2021-2022,30,fr FRA,Lorient,fr Ligue 1,34,2248,25.0,26,8,1,3,2,5,3,0,0,0,MF,84d94b91,Full Starter
2423,Anastasios Douvikas,3,2024-2025,24,gr GRE,Celta Vigo,es La Liga,18,651,7.2,6,12,2,3,1,4,3,0,0,0,FW,853ca71c,Bench Player
2424,Álex Muñoz,3,2024-2025,30,es ESP,Las Palmas,es La Liga,14,983,10.9,12,2,6,3,0,3,3,0,0,0,DF,853f211e,Rotational Player
2425,Grégoire Defrel,3,2020-2021,29,mq MTQ,Sassuolo,it Serie A,28,1336,14.8,14,14,1,3,3,6,3,0,0,0,MFFW,854ee61a,Rotational Player
2426,Mahdi Camara,3,2024-2025,26,fr FRA,Brest,fr Ligue 1,19,1398,15.5,16,3,0,3,2,5,3,0,0,0,MF,8577e60a,Full Starter
2427,Mahdi Camara,3,2021-2022,23,fr FRA,Saint-Étienne,fr Ligue 1,35,3073,34.1,34,1,0,3,0,3,3,0,0,0,MFDF,8577e60a,Full Starter
2428,Mahdi Camara,3,2020-2021,22,fr FRA,Saint-Étienne,fr Ligue 1,37,3290,36.6,37,0,0,3,2,5,3,0,0,0,MFDF,8577e60a,Full Starter
2429,Christian Günter,3,2020-2021,27,de GER,Freiburg,de Bundesliga,34,3060,34.0,34,0,0,3,3,6,3,0,0,0,DFMF,8593f88c,Full Starter
2430,Lassana Coulibaly,3,2022-2023,26,ml MLI,Salernitana,it Serie A,35,2892,32.1,34,1,0,3,3,6,3,0,0,0,MF,85a44ecc,Full Starter
2431,Miguel Almirón,3,2023-2024,29,py PAR,Newcastle Utd,eng Premier League,33,1937,21.5,23,10,0,3,1,4,3,0,0,0,FW,862a1c15,Full Starter
2432,Paul Pogba,3,2020-2021,27,fr FRA,Manchester Utd,eng Premier League,26,1897,21.1,21,5,3,3,3,6,3,0,0,0,MFFW,867239d3,Rotational Player
2433,Munir El Haddadi,3,2023-2024,27,ma MAR,Las Palmas,es La Liga,38,2449,27.2,32,6,0,3,2,5,3,0,1,1,FW,8696bc90,Rotational Player
2434,Munir El Haddadi,3,2022-2023,26,ma MAR,2 Teams,es La Liga,28,1150,12.8,10,18,5,3,1,4,3,0,0,0,MFFW,8696bc90,Rotational Player
2435,Maximilian Arnold,3,2020-2021,26,de GER,Wolfsburg,de Bundesliga,30,2585,28.7,30,0,0,3,6,9,3,0,0,0,MF,86e119e0,Full Starter
2436,Thiago Silva,3,2023-2024,38,br BRA,Chelsea,eng Premier League,31,2527,28.1,28,3,5,3,1,4,3,0,0,0,DF,86e7deaf,Full Starter
2437,Thiago Silva,3,2021-2022,36,br BRA,Chelsea,eng Premier League,32,2650,29.4,28,4,4,3,0,3,3,0,0,0,DF,86e7deaf,Full Starter
2438,Sergio Camello,3,2024-2025,23,es ESP,Rayo Vallecano,es La Liga,21,1081,12.0,13,8,0,3,2,5,3,0,0,0,FW,873619c6,Rotational Player
2439,Sergio Camello,3,2023-2024,22,es ESP,Rayo Vallecano,es La Liga,31,1661,18.5,20,11,6,3,1,4,3,0,0,0,FW,873619c6,Rotational Player
2440,Gianluca Scamacca,3,2022-2023,23,it ITA,West Ham,eng Premier League,16,926,10.3,11,5,4,3,0,3,3,0,0,0,FW,8790f988,Rotational Player
2441,Papa Ndiaga Yade,3,2020-2021,20,mr MTN,Metz,fr Ligue 1,28,1001,11.1,9,19,10,3,4,7,3,0,0,0,FWMF,87e9c7cd,Bench Player
2442,Unai López,3,2024-2025,28,es ESP,Rayo Vallecano,es La Liga,18,1021,11.3,14,4,1,3,0,3,3,0,0,0,MF,88050721,Rotational Player
2443,Unai López,3,2020-2021,24,es ESP,Athletic Club,es La Liga,26,1424,15.8,15,11,9,3,0,3,3,0,0,0,MF,88050721,Rotational Player
2444,Mathias Pereira Lage,3,2023-2024,26,pt POR,Brest,fr Ligue 1,30,1187,13.2,12,18,1,3,2,5,3,0,0,0,FWMF,8846a40f,Rotational Player
2445,Serge Gnabry,3,2024-2025,29,de GER,Bayern Munich,de Bundesliga,13,628,7.0,7,6,2,3,2,5,3,0,0,0,FWMF,88e357ef,Rotational Player
2446,Serge Gnabry,3,2023-2024,28,de GER,Bayern Munich,de Bundesliga,10,432,4.8,5,5,3,3,1,4,3,0,0,0,FWMF,88e357ef,Rotational Player
2447,Rico Henry,3,2021-2022,24,eng ENG,Brentford,eng Premier League,34,2776,30.8,33,1,0,3,0,3,3,0,0,0,DF,8a3c1dc7,Full Starter
2448,Monchu,3,2022-2023,22,es ESP,Valladolid,es La Liga,33,2031,22.6,23,10,3,3,2,5,3,0,0,0,MF,8ac501f5,Rotational Player
2449,Assane Diao,3,2024-2025,18,es ESP,2 Teams,2 Comps,14,617,6.9,5,9,8,3,2,5,3,0,0,0,FWMF,8ae7d0ec,Bench Player
2450,Pascal Groß,3,2020-2021,29,de GER,Brighton,eng Premier League,34,2484,27.6,27,7,4,3,8,11,0,3,4,1,MFDF,8aec0537,Full Starter
2451,Wilfried Singo,3,2021-2022,20,ci CIV,Torino,it Serie A,35,2607,29.0,32,3,0,3,4,7,3,0,0,0,DF,8b609c34,Full Starter
2452,Adil Rami,3,2021-2022,35,fr FRA,Troyes,fr Ligue 1,17,1171,13.0,14,3,2,3,0,3,3,0,0,0,DF,8dbff17c,Rotational Player
2453,Ben Mee,3,2022-2023,32,eng ENG,Brentford,eng Premier League,37,3269,36.3,37,0,1,3,1,4,3,0,0,0,DF,8df7a2fb,Full Starter
2454,Ben Mee,3,2021-2022,31,eng ENG,Burnley,eng Premier League,21,1839,20.4,21,0,0,3,0,3,3,0,0,0,DF,8df7a2fb,Full Starter
2455,Dan Ndoye,3,2024-2025,23,ch SUI,Bologna,it Serie A,17,1108,12.3,14,3,0,3,2,5,2,1,1,0,FW,8e697a8f,Rotational Player
2456,Sheraldo Becker,3,2020-2021,25,sr SUR,Union Berlin,de Bundesliga,18,1106,12.3,15,3,1,3,3,6,3,0,0,0,FWMF,8eb55dbb,Rotational Player
2457,Timothy Weah,3,2021-2022,21,us USA,Lille,fr Ligue 1,29,1616,18.0,17,12,1,3,4,7,3,0,0,0,MFFW,8eec784d,Rotational Player
2458,Timothy Weah,3,2020-2021,20,us USA,Lille,fr Ligue 1,28,878,9.8,7,21,6,3,0,3,3,0,0,0,FWMF,8eec784d,Rotational Player
2459,Manolo Gabbiadini,3,2020-2021,28,it ITA,Sampdoria,it Serie A,16,870,9.7,10,6,7,3,2,5,2,1,1,0,FW,8f866fe8,Rotational Player
2460,Guido Carrillo,3,2020-2021,29,ar ARG,Elche,es La Liga,21,1002,11.1,11,10,1,3,2,5,3,0,0,0,FW,8f898ba8,Rotational Player
2461,Micky van de Ven,3,2023-2024,22,nl NED,Tottenham,eng Premier League,27,2339,26.0,27,0,1,3,0,3,3,0,0,0,DF,8fe2a392,Full Starter
2462,Carlos Vicente,3,2024-2025,25,es ESP,Alavés,es La Liga,19,1683,18.7,19,0,1,3,3,6,3,0,0,0,FWMF,90df343e,Rotational Player
2463,José Fonte,3,2020-2021,36,pt POR,Lille,fr Ligue 1,36,3185,35.4,36,0,0,3,0,3,3,0,0,0,DF,90f87966,Full Starter
2464,John McGinn,3,2020-2021,25,sct SCO,Aston Villa,eng Premier League,37,3330,37.0,37,0,0,3,5,8,3,0,0,0,MF,90f91999,Full Starter
2465,John McGinn,3,2021-2022,26,sct SCO,Aston Villa,eng Premier League,35,3090,34.3,35,0,0,3,4,7,3,0,0,0,MF,90f91999,Full Starter
2466,Christopher Operi,3,2023-2024,26,ci CIV,Le Havre,fr Ligue 1,28,2445,27.2,28,0,0,3,4,7,3,0,0,0,DF,914bb955,Full Starter
2467,Raúl Moro,3,2024-2025,21,es ESP,Valladolid,es La Liga,19,1306,14.5,14,5,0,3,1,4,3,0,0,0,FWMF,919dd4b1,Rotational Player
2468,Amadou Haidara,3,2020-2021,22,ml MLI,RB Leipzig,de Bundesliga,31,1905,21.2,21,10,1,3,1,4,3,0,0,0,MFFW,92432bc6,Rotational Player
2469,Amadou Haidara,3,2021-2022,23,ml MLI,RB Leipzig,de Bundesliga,20,1326,14.7,15,5,0,3,1,4,3,0,0,0,MF,92432bc6,Rotational Player
2470,Grischa Prömel,3,2020-2021,25,de GER,Union Berlin,de Bundesliga,24,1816,20.2,21,3,0,3,1,4,3,0,0,0,MF,924f9191,Full Starter
2471,Jens Cajuste,3,2022-2023,22,se SWE,Reims,fr Ligue 1,31,1530,17.0,14,17,0,3,1,4,3,0,0,0,MF,928a4a61,Rotational Player
2472,Mattias Svanberg,3,2021-2022,22,se SWE,Bologna,it Serie A,36,2564,28.5,31,5,1,3,3,6,3,0,0,0,MF,92d83c27,Full Starter
2473,Jan Schöppner,3,2024-2025,25,de GER,Heidenheim,de Bundesliga,19,1553,17.3,18,1,0,3,1,4,3,0,0,0,MF,932bfcac,Rotational Player
2474,Dominik Szoboszlai,3,2023-2024,22,hu HUN,Liverpool,eng Premier League,33,2104,23.4,25,8,0,3,2,5,3,0,0,0,MF,934e1968,Rotational Player
2475,Dominik Szoboszlai,3,2024-2025,23,hu HUN,Liverpool,eng Premier League,20,1368,15.2,15,5,0,3,2,5,3,0,0,0,MF,934e1968,Rotational Player
2476,Timo Hübers,3,2022-2023,26,de GER,Köln,de Bundesliga,29,2559,28.4,28,1,0,3,0,3,3,0,0,0,DF,94302c52,Full Starter
2477,Riccardo Sottil,3,2021-2022,22,it ITA,Fiorentina,it Serie A,24,1239,13.8,14,10,9,3,2,5,3,0,0,0,FW,94816803,Rotational Player
2478,Danilo,3,2022-2023,31,br BRA,Juventus,it Serie A,37,3184,35.4,35,2,0,3,3,6,3,0,0,0,DF,94b2001f,Rotational Player
2479,Giulio Maggiore,3,2020-2021,22,it ITA,Spezia,it Serie A,33,2214,24.6,26,7,0,3,1,4,3,0,0,0,MF,957e4c87,Rotational Player
2480,Junior Dina Ebimbe,3,2022-2023,21,fr FRA,Eint Frankfurt,de Bundesliga,19,1063,11.8,10,9,3,3,1,4,3,0,0,0,DFMF,95bb6ddc,Rotational Player
2481,Gonçalo Paciência,3,2023-2024,28,pt POR,2 Teams,2 Comps,19,650,7.2,6,13,9,3,1,4,3,0,0,0,FW,962e54cb,Bench Player
2482,Gonçalo Paciência,3,2021-2022,26,pt POR,Eint Frankfurt,de Bundesliga,18,516,5.7,4,14,8,3,0,3,2,1,2,1,FW,962e54cb,Bench Player
2483,Tolgay Arslan,3,2020-2021,29,de GER,Udinese,it Serie A,30,1818,20.2,25,5,3,3,0,3,3,0,0,0,MF,963a328b,Rotational Player
2484,James Mcatee,3,2023-2024,20,eng ENG,2 Teams,eng Premier League,31,1823,20.3,20,11,4,3,3,6,2,1,1,0,MFFW,96593e89,Rotational Player
2485,Mason Mount,3,2022-2023,23,eng ENG,Chelsea,eng Premier League,24,1648,18.3,20,4,2,3,2,5,3,0,0,0,MFFW,9674002f,Full Starter
2486,Matteo Darmian,3,2020-2021,30,it ITA,2 Teams,it Serie A,29,1368,15.2,16,13,8,3,3,6,3,0,0,0,DF,96e0490d,Rotational Player
2487,Federico Dimarco,3,2024-2025,26,it ITA,Inter,it Serie A,19,1409,15.7,18,1,2,3,4,7,3,0,0,0,DFFW,970b8574,Full Starter
2488,Ivan Cavaleiro,3,2020-2021,26,pt POR,Fulham,eng Premier League,36,2472,27.5,27,9,0,3,0,3,2,1,2,1,FW,979b811d,Full Starter
2489,Ko Itakura,3,2023-2024,26,jp JPN,Gladbach,de Bundesliga,20,1596,17.7,18,2,0,3,0,3,3,0,0,0,DFMF,97d545ae,Rotational Player
2490,Christian Eriksen,3,2020-2021,28,dk DEN,Inter,it Serie A,26,1385,15.4,17,9,11,3,0,3,3,0,0,0,MF,980522ec,Rotational Player
2491,Kalifa Coulibaly,3,2020-2021,28,ml MLI,Nantes,fr Ligue 1,17,981,10.9,11,6,7,3,1,4,2,1,1,0,FW,9980269a,Rotational Player
2492,Dion Drena Beljo,3,2022-2023,20,hr CRO,Augsburg,de Bundesliga,18,1128,12.5,16,2,1,3,2,5,3,0,0,0,FW,9a2e3a23,Rotational Player
2493,Rayan Aït-Nouri,3,2024-2025,23,dz ALG,Wolves,eng Premier League,22,1881,20.9,22,0,0,3,5,8,3,0,0,0,DF,9b398aea,Rotational Player
2494,Lamine Gueye,3,2020-2021,22,sn SEN,Metz,fr Ligue 1,26,1454,16.2,19,7,4,3,2,5,3,0,0,0,FWMF,9d5dcc23,Rotational Player
2495,Roberto Soldado,3,2021-2022,36,es ESP,Levante,es La Liga,18,664,7.4,7,11,7,3,2,5,3,0,0,0,FW,9d66fbe3,Rotational Player
2496,Cheikh Tidiane Sabaly,3,2023-2024,24,sn SEN,Metz,fr Ligue 1,29,1379,15.3,17,12,2,3,1,4,3,0,0,0,FWMF,9ddf7fae,Rotational Player
2497,Désiré Doué,3,2022-2023,17,fr FRA,Rennes,fr Ligue 1,26,1115,12.4,11,15,3,3,1,4,3,0,0,0,MFFW,9e7483ff,Rotational Player
2498,Thomas Henry,3,2023-2024,28,fr FRA,Hellas Verona,it Serie A,18,334,3.7,2,16,8,3,0,3,3,0,1,1,FW,9ef42479,Rotational Player
2499,Mario Götze,3,2022-2023,30,de GER,Eint Frankfurt,de Bundesliga,32,2740,30.4,32,0,0,3,1,4,3,0,0,0,MF,9efa1d25,Full Starter
2500,Mario Götze,3,2023-2024,31,de GER,Eint Frankfurt,de Bundesliga,30,2068,23.0,23,7,1,3,2,5,3,0,0,0,MF,9efa1d25,Full Starter
2501,Neto Borges,3,2022-2023,25,br BRA,Clermont Foot,fr Ligue 1,33,2833,31.5,33,0,0,3,1,4,3,0,0,0,DF,9f936061,Full Starter
2502,Carlos Benavídez,3,2023-2024,25,uy URU,Alavés,es La Liga,29,1136,12.6,10,19,4,3,1,4,3,0,0,0,MF,9fb45456,Rotational Player
2503,Romain Saïss,3,2020-2021,30,ma MAR,Wolves,eng Premier League,27,2407,26.7,27,0,7,3,0,3,3,0,0,0,DF,9fbbcf39,Full Starter
2504,Aleix García,3,2023-2024,26,es ESP,Girona,es La Liga,37,3199,35.5,36,1,0,3,6,9,3,0,0,0,MF,a10361d2,Full Starter
2505,Julian Brandt,3,2020-2021,24,de GER,Dortmund,de Bundesliga,31,1495,16.6,17,14,3,3,2,5,3,0,0,0,FWMF,a167537f,Rotational Player
2506,Ibrahim Sissoko,3,2024-2025,28,ml MLI,Saint-Étienne,fr Ligue 1,15,802,8.9,8,7,0,3,1,4,2,1,1,0,FW,a170541f,Bench Player
2507,Jodel Dossou,3,2021-2022,29,bj BEN,Clermont Foot,fr Ligue 1,35,2008,22.3,23,12,2,3,1,4,3,0,0,0,FW,a1dbfcb1,Rotational Player
2508,Antonio Sánchez,3,2023-2024,26,es ESP,Mallorca,es La Liga,29,1452,16.1,21,8,9,3,1,4,3,0,0,0,MF,a254bbe0,Rotational Player
2509,Steven Bergwijn,3,2021-2022,23,nl NED,Tottenham,eng Premier League,25,565,6.3,4,21,7,3,1,4,3,0,0,0,FWMF,a29b1131,Bench Player
2510,Lucas Pérez,3,2022-2023,33,es ESP,Cádiz,es La Liga,14,628,7.0,5,9,1,3,0,3,3,0,0,0,FW,a300ac7e,Rotational Player
2511,Eden Hazard,3,2020-2021,29,be BEL,Real Madrid,es La Liga,14,532,5.9,7,7,1,3,2,5,3,0,0,0,FWMF,a39bb753,Bench Player
2512,Joe Willock,3,2022-2023,22,eng ENG,Newcastle Utd,eng Premier League,35,2558,28.4,31,4,0,3,6,9,3,0,0,0,MF,a3b03921,Rotational Player
2513,Mark Uth,3,2020-2021,28,de GER,Schalke 04,de Bundesliga,20,1494,16.6,18,2,0,3,1,4,3,0,0,0,FWMF,a3ddb1b9,Rotational Player
2514,Pietro Pellegri,3,2024-2025,23,it ITA,2 Teams,it Serie A,11,414,4.6,5,6,3,3,0,3,3,0,0,0,FW,a44d3a3c,Bench Player
2515,Haris Seferović,3,2022-2023,30,ch SUI,Celta Vigo,es La Liga,18,887,9.9,10,8,1,3,1,4,3,0,0,0,FW,a45eac1f,Rotational Player
2516,Lucas Stassin,3,2024-2025,19,be BEL,Saint-Étienne,fr Ligue 1,16,889,9.9,11,5,0,3,4,7,3,0,0,0,FW,a47d6f3a,Rotational Player
2517,M'Bala Nzola,3,2023-2024,26,ao ANG,Fiorentina,it Serie A,33,1552,17.2,15,18,1,3,3,6,2,1,1,0,FW,a4948e67,Rotational Player
2518,Hamari Traoré,3,2021-2022,29,ml MLI,Rennes,fr Ligue 1,33,2890,32.1,33,0,2,3,10,13,3,0,0,0,DF,a4b1028a,Full Starter
2519,Patrick Cutrone,3,2021-2022,23,it ITA,Empoli,it Serie A,28,1401,15.6,15,13,9,3,0,3,3,0,0,0,FW,a4fe8cda,Rotational Player
2520,Piotr Zieliński,3,2023-2024,29,pl POL,Napoli,it Serie A,28,1924,21.4,23,5,2,3,2,5,2,1,1,0,MF,a5296e55,Full Starter
2521,Piotr Zieliński,3,2022-2023,28,pl POL,Napoli,it Serie A,37,2287,25.4,27,10,1,3,8,11,3,0,0,0,MF,a5296e55,Full Starter
2522,Orel Mangala,3,2023-2024,25,be BEL,2 Teams,2 Comps,28,1961,21.8,23,5,4,3,0,3,3,0,0,0,MF,a572e291,Rotational Player
2523,Alexander Hack,3,2021-2022,27,de GER,Mainz 05,de Bundesliga,28,2074,23.0,24,4,1,3,1,4,3,0,0,0,DF,a5ec3ede,Rotational Player
2524,Simon Sohm,3,2024-2025,23,ch SUI,Parma,it Serie A,22,1778,19.8,21,1,0,3,0,3,3,0,0,0,MF,a5f458d9,Rotational Player
2525,Randy Nteka,3,2024-2025,26,ao ANG,Rayo Vallecano,es La Liga,16,661,7.3,8,8,5,3,0,3,3,0,0,0,FW,a6103274,Rotational Player
2526,Randy Nteka,3,2021-2022,23,ao ANG,Rayo Vallecano,es La Liga,34,1462,16.2,16,18,1,3,0,3,3,0,0,0,FWMF,a6103274,Rotational Player
2527,Kamaldeen Sulemana,3,2022-2023,20,gh GHA,2 Teams,2 Comps,32,1292,14.4,12,20,4,3,1,4,3,0,0,0,FWMF,a62f8bf1,Rotational Player
2528,Hirving Lozano,3,2022-2023,27,mx MEX,Napoli,it Serie A,32,1605,17.8,20,12,1,3,3,6,2,1,1,0,FW,a69e4806,Rotational Player
2529,Rodrigo Muniz,3,2024-2025,23,br BRA,Fulham,eng Premier League,22,654,7.3,5,17,1,3,1,4,3,0,0,0,FW,a755db8c,Rotational Player
2530,João Palhinha,3,2022-2023,27,pt POR,Fulham,eng Premier League,35,3108,34.5,35,0,0,3,0,3,3,0,0,0,MF,a78ff07f,Full Starter
2531,Danilo,3,2022-2023,21,br BRA,Nott'ham Forest,eng Premier League,13,976,10.8,12,1,3,3,2,5,3,0,0,0,MF,a816dbfb,Rotational Player
2532,Benjamín Domínguez,3,2024-2025,20,ar ARG,Bologna,it Serie A,9,594,6.6,8,1,9,3,1,4,3,0,0,0,FW,a83b47fa,Bench Player
2533,Mitchel Bakker,3,2022-2023,22,nl NED,Leverkusen,de Bundesliga,28,1659,18.4,19,9,4,3,2,5,3,0,0,0,DFMF,a8567629,Rotational Player
2534,Manuel Locatelli,3,2021-2022,23,it ITA,Juventus,it Serie A,31,2160,24.0,23,8,0,3,3,6,3,0,0,0,MF,a8a874f1,Full Starter
2535,Carles Pérez,3,2022-2023,24,es ESP,Celta Vigo,es La Liga,35,2144,23.8,23,12,1,3,5,8,3,0,0,0,MFFW,a8f21b9f,Rotational Player
2536,Aleksei Miranchuk,3,2023-2024,27,ru RUS,Atalanta,it Serie A,27,1176,13.1,12,15,8,3,5,8,3,0,0,0,MFFW,a9aa0d1d,Rotational Player
2537,Álex Fernández,3,2021-2022,28,es ESP,Cádiz,es La Liga,32,2051,22.8,22,10,4,3,2,5,2,1,2,1,MF,aa677a35,Rotational Player
2538,Álex Fernández,3,2022-2023,29,es ESP,Cádiz,es La Liga,28,1576,17.5,17,11,3,3,0,3,2,1,1,0,MFFW,aa677a35,Rotational Player
2539,Jack Harrison,3,2023-2024,26,eng ENG,Everton,eng Premier League,29,2214,24.6,25,4,1,3,3,6,3,0,0,0,MFFW,aa849a12,Full Starter
2540,Nikola Vlašić,3,2023-2024,25,hr CRO,Torino,it Serie A,33,2608,29.0,30,3,0,3,2,5,3,0,0,0,MFFW,aa8e289e,Full Starter
2541,Amine Gouiri,3,2024-2025,24,dz ALG,Rennes,fr Ligue 1,19,1037,11.5,11,8,0,3,2,5,3,0,0,0,MFFW,aad56ca3,Full Starter
2542,Daniel Vivian,3,2024-2025,25,es ESP,Athletic Club,es La Liga,18,1495,16.6,16,2,3,3,0,3,3,0,0,0,DF,ab7bf91d,Rotational Player
2543,Nathaniel Brown,3,2024-2025,21,de GER,Eint Frankfurt,de Bundesliga,11,809,9.0,9,2,2,3,3,6,3,0,0,0,DFMF,abc79c47,Bench Player
2544,Gabriel Strefezza,3,2024-2025,27,br BRA,Como,it Serie A,21,1614,17.9,21,0,0,3,3,6,3,0,0,0,FWMF,ac4a4508,Full Starter
2545,Nordi Mukiele,3,2020-2021,22,fr FRA,RB Leipzig,de Bundesliga,28,1677,18.6,21,7,2,3,1,4,3,0,0,0,DF,ac73ec79,Rotational Player
2546,Axel Disasi,3,2020-2021,22,fr FRA,Monaco,fr Ligue 1,29,2011,22.3,24,5,6,3,0,3,3,0,0,0,DF,ad82197c,Full Starter
2547,Axel Disasi,3,2022-2023,24,fr FRA,Monaco,fr Ligue 1,38,3330,37.0,37,1,0,3,3,6,3,0,1,1,DF,ad82197c,Full Starter
2548,Dani Olmo,3,2021-2022,23,es ESP,RB Leipzig,de Bundesliga,19,743,8.3,7,12,1,3,3,6,3,0,0,0,MFFW,ae44e8e2,Rotational Player
2549,Iván Martín,3,2022-2023,23,es ESP,Girona,es La Liga,24,1586,17.6,18,6,7,3,3,6,3,0,0,0,MF,ae48c5cb,Full Starter
2550,Jayden Bogle,3,2023-2024,23,eng ENG,Sheffield Utd,eng Premier League,34,2788,31.0,32,2,1,3,0,3,3,0,0,0,DF,ae5019e6,Full Starter
2551,Tijjani Reijnders,3,2023-2024,25,nl NED,Milan,it Serie A,36,2820,31.3,33,3,1,3,3,6,3,0,0,0,MF,afb61630,Full Starter
2552,Jack Grealish,3,2023-2024,27,eng ENG,Manchester City,eng Premier League,20,1009,11.2,10,10,9,3,1,4,3,0,0,0,FWMF,b0b4fd3e,Rotational Player
2553,Jack Grealish,3,2021-2022,25,eng ENG,Manchester City,eng Premier League,26,1914,21.3,22,4,8,3,3,6,3,0,0,0,FW,b0b4fd3e,Rotational Player
2554,Mikel Vesga,3,2023-2024,30,es ESP,Athletic Club,es La Liga,27,1534,17.0,18,9,6,3,1,4,1,2,2,0,MF,b0fce72c,Rotational Player
2555,Mikel Vesga,3,2022-2023,29,es ESP,Athletic Club,es La Liga,36,2575,28.6,28,8,0,3,3,6,1,2,3,1,MF,b0fce72c,Rotational Player
2556,Hans Nicolussi Caviglia,3,2024-2025,24,it ITA,Venezia,it Serie A,19,1429,15.9,17,2,0,3,2,5,3,0,0,0,MF,b136c945,Rotational Player
2557,Ousmane Dembélé,3,2023-2024,26,fr FRA,Paris S-G,fr Ligue 1,26,1506,16.7,17,9,2,3,8,11,3,0,0,0,MFFW,b19db005,Rotational Player
2558,Filip Kostić,3,2022-2023,29,rs SRB,2 Teams,2 Comps,38,2638,29.3,34,4,1,3,8,11,3,0,0,0,DFMF,b1cd37e6,Full Starter
2559,Joël Matip,3,2021-2022,29,cm CMR,Liverpool,eng Premier League,31,2790,31.0,31,0,4,3,3,6,3,0,0,0,DF,b217ef29,Full Starter
2560,Didier Lamkel Zé,3,2021-2022,24,cm CMR,Metz,fr Ligue 1,9,605,6.7,8,1,0,3,0,3,3,0,0,0,FW,b229aa13,Bench Player
2561,Andros Townsend,3,2021-2022,30,eng ENG,Everton,eng Premier League,21,1455,16.2,17,4,4,3,2,5,2,1,1,0,MFFW,b28bbd58,Rotational Player
2562,Jonathan Bamba,3,2023-2024,27,ci CIV,Celta Vigo,es La Liga,27,1981,22.0,24,3,3,3,2,5,3,0,0,0,MFFW,b2bd0f6c,Full Starter
2563,Suat Serdar,3,2021-2022,24,de GER,Hertha BSC,de Bundesliga,30,2218,24.6,27,3,0,3,0,3,3,0,0,0,MFFW,b3325a30,Full Starter
2564,Rayan Cherki,3,2024-2025,20,fr FRA,Lyon,fr Ligue 1,15,886,9.8,10,5,0,3,3,6,3,0,0,0,FWMF,b34c63a5,Rotational Player
2565,Aurélio Buta,3,2022-2023,25,pt POR,Eint Frankfurt,de Bundesliga,18,1318,14.6,15,3,1,3,2,5,3,0,0,0,DF,b4705807,Rotational Player
2566,Tiago Tomás,3,2022-2023,20,pt POR,Stuttgart,de Bundesliga,27,1291,14.3,16,11,1,3,3,6,3,0,0,0,FWMF,b492126a,Rotational Player
2567,Diego Carlos,3,2021-2022,28,br BRA,Sevilla,es La Liga,34,2957,32.9,34,0,0,3,0,3,3,0,0,0,DF,b4a014b1,Full Starter
2568,Sebastian Andersson,3,2020-2021,29,se SWE,Köln,de Bundesliga,16,1126,12.5,14,2,1,3,0,3,2,1,1,0,FW,b4cf5806,Rotational Player
2569,Sebastian Andersson,3,2021-2022,30,se SWE,Köln,de Bundesliga,26,1257,14.0,13,13,1,3,1,4,3,0,0,0,FW,b4cf5806,Rotational Player
2570,Jean Onana,3,2021-2022,21,cm CMR,2 Teams,fr Ligue 1,23,1832,20.4,23,0,2,3,2,5,3,0,0,0,MF,b5bb8188,Rotational Player
2571,Matúš Bero,3,2024-2025,28,sk SVK,Bochum,de Bundesliga,16,1372,15.2,15,1,0,3,0,3,3,0,0,0,MF,b5e0af76,Rotational Player
2572,Maghnes Akliouche,3,2024-2025,22,fr FRA,Monaco,fr Ligue 1,17,1195,13.3,13,4,0,3,5,8,3,0,0,0,FWMF,b625b241,Rotational Player
2573,Mohammed Kudus,3,2024-2025,23,gh GHA,West Ham,eng Premier League,18,1473,16.4,18,0,0,3,1,4,3,0,0,0,MFFW,b62878a5,Rotational Player
2574,Gabriel Jesus,3,2024-2025,27,br BRA,Arsenal,eng Premier League,17,608,6.8,6,11,1,3,0,3,3,0,0,0,FW,b66315ae,Rotational Player
2575,Ismaël Traoré,3,2020-2021,33,ci CIV,Angers,fr Ligue 1,34,2993,33.3,34,0,1,3,3,6,3,0,0,0,DF,b666421b,Full Starter
2576,Chris Smalling,3,2021-2022,31,eng ENG,Roma,it Serie A,27,2091,23.2,23,4,3,3,0,3,3,0,0,0,DF,b6964eb6,Full Starter
2577,Chris Smalling,3,2022-2023,32,eng ENG,Roma,it Serie A,32,2808,31.2,31,1,2,3,1,4,3,0,0,0,DF,b6964eb6,Full Starter
2578,Matteo Cancellieri,3,2024-2025,22,it ITA,Parma,it Serie A,20,1001,11.1,13,7,1,3,0,3,3,0,0,0,FWMF,b6a1cdf9,Rotational Player
2579,Yuri Berchiche,3,2023-2024,33,es ESP,Athletic Club,es La Liga,27,1930,21.4,22,5,0,3,1,4,3,0,0,0,DF,b6e50615,Rotational Player
2580,Stefano Sensi,3,2022-2023,26,it ITA,Monza,it Serie A,28,1618,18.0,21,7,5,3,1,4,3,0,0,0,MF,b70bde8f,Rotational Player
2581,Evann Guessand,3,2022-2023,21,ci CIV,Nantes,fr Ligue 1,30,1260,14.0,15,15,2,3,2,5,3,0,0,0,FWMF,b73f17f8,Rotational Player
2582,Albert Guðmundsson,3,2024-2025,27,is ISL,Fiorentina,it Serie A,11,563,6.3,8,3,2,3,0,3,1,2,2,0,MFFW,b79858d5,Rotational Player
2583,Víctor Laguardia,3,2021-2022,31,es ESP,Alavés,es La Liga,34,3042,33.8,34,0,2,3,2,5,3,0,0,0,DF,b7c99b9b,Full Starter
2584,Antonio Raillo,3,2023-2024,31,es ESP,Mallorca,es La Liga,26,2195,24.4,25,1,3,3,2,5,3,0,0,0,DF,b857bd29,Rotational Player
2585,Samuel Chukwueze,3,2021-2022,22,ng NGA,Villarreal,es La Liga,27,1333,14.8,12,15,0,3,3,6,3,0,0,0,MFFW,b8a642fc,Rotational Player
2586,Francesco Acerbi,3,2023-2024,35,it ITA,Inter,it Serie A,29,2388,26.5,26,3,2,3,1,4,3,0,0,0,DF,b96b595c,Full Starter
2587,Niklas Schmidt,3,2022-2023,24,de GER,Werder Bremen,de Bundesliga,24,1087,12.1,11,13,9,3,0,3,3,0,0,0,MF,b9ae8560,Rotational Player
2588,Harvey Elliott,3,2023-2024,20,eng ENG,Liverpool,eng Premier League,34,1352,15.0,11,23,4,3,6,9,3,0,0,0,MFFW,b9e1436c,Rotational Player
2589,Sébastien Haller,3,2020-2021,26,ci CIV,West Ham,eng Premier League,16,937,10.4,10,6,0,3,0,3,3,0,0,0,FW,ba115a40,Rotational Player
2590,Danilo Cataldi,3,2024-2025,29,it ITA,2 Teams,it Serie A,13,884,9.8,12,1,2,3,0,3,3,0,0,0,MF,ba3d3bea,Rotational Player
2591,Ivan Ilić,3,2023-2024,22,rs SRB,Torino,it Serie A,31,2098,23.3,25,6,1,3,2,5,3,0,0,0,MF,bb376bed,Rotational Player
2592,Sergi Enrich,3,2020-2021,30,es ESP,Eibar,es La Liga,27,1404,15.6,13,14,5,3,0,3,3,0,1,1,FW,bb4b1242,Rotational Player
2593,Solly March,3,2023-2024,29,eng ENG,Brighton,eng Premier League,7,554,6.2,7,0,1,3,1,4,3,0,0,0,FWDF,bb5fbd2b,Rotational Player
2594,Diego Llorente,3,2021-2022,27,es ESP,Leeds United,eng Premier League,28,2340,26.0,28,0,2,3,0,3,3,0,0,0,DF,bba30585,Full Starter
2595,Amine Salama,3,2022-2023,22,fr FRA,Angers,fr Ligue 1,25,1249,13.9,12,13,2,3,1,4,3,0,0,0,FWMF,bc7cc472,Rotational Player
2596,João Cancelo,3,2022-2023,28,pt POR,2 Teams,2 Comps,32,2286,25.4,27,5,4,3,5,8,3,0,0,0,DF,bd6351cd,Full Starter
2597,Hannes Wolf,3,2020-2021,21,at AUT,Gladbach,de Bundesliga,32,1378,15.3,14,18,2,3,2,5,3,0,0,0,MFFW,be42a291,Rotational Player
2598,Karim Bellarabi,3,2021-2022,31,de GER,Leverkusen,de Bundesliga,16,683,7.6,9,7,1,3,2,5,3,0,0,0,FWMF,bee0bab1,Bench Player
2599,Nikola Milenković,3,2020-2021,22,rs SRB,Fiorentina,it Serie A,34,3034,33.7,34,0,1,3,1,4,3,0,0,0,DF,bee704fc,Full Starter
2600,Roland Sallai,3,2023-2024,26,hu HUN,Freiburg,de Bundesliga,27,1840,20.4,22,5,0,3,2,5,3,0,1,1,MFFW,bf075f6b,Rotational Player
2601,Federico Bonazzoli,3,2023-2024,26,it ITA,Hellas Verona,it Serie A,24,1016,11.3,10,14,14,3,1,4,3,0,0,0,FWMF,bf57eaab,Rotational Player
2602,Ismaila Sarr,3,2023-2024,25,sn SEN,Marseille,fr Ligue 1,23,1447,16.1,15,8,2,3,4,7,3,0,0,0,FWMF,bfdb33aa,Rotational Player
2603,Randal Kolo Muani,3,2024-2025,25,fr FRA,2 Teams,2 Comps,11,439,4.9,3,8,3,3,1,4,2,1,1,0,FW,c0b3669f,Rotational Player
2604,Fabián Ruiz Peña,3,2022-2023,26,es ESP,Paris S-G,fr Ligue 1,27,1892,21.0,21,6,0,3,2,5,3,0,0,0,MF,c0c7ff58,Full Starter
2605,Fabián Ruiz Peña,3,2020-2021,24,es ESP,Napoli,it Serie A,33,2569,28.5,29,4,1,3,1,4,3,0,0,0,MF,c0c7ff58,Full Starter
2606,Wataru Endo,3,2020-2021,27,jp JPN,Stuttgart,de Bundesliga,33,2955,32.8,33,0,0,3,3,6,3,0,0,0,MF,c149016b,Full Starter
2607,Saúl Ñíguez,3,2022-2023,27,es ESP,Atlético Madrid,es La Liga,31,1100,12.2,11,20,6,3,1,4,3,0,0,0,MFDF,c14bc029,Rotational Player
2608,Peter Pekarík,3,2020-2021,33,sk SVK,Hertha BSC,de Bundesliga,23,1692,18.8,22,1,11,3,1,4,3,0,0,0,DF,c18d22f5,Rotational Player
2609,Jarrad Branthwaite,3,2023-2024,21,eng ENG,Everton,eng Premier League,35,3116,34.6,35,0,2,3,0,3,3,0,0,0,DF,c1949191,Full Starter
2610,Konrad Laimer,3,2022-2023,25,at AUT,RB Leipzig,de Bundesliga,21,1468,16.3,17,4,1,3,0,3,3,0,0,0,MF,c1b7847c,Rotational Player
2611,Jonas Hector,3,2020-2021,30,de GER,Köln,de Bundesliga,19,1290,14.3,15,4,1,3,1,4,3,0,0,0,MFFW,c2009df3,Rotational Player
2612,Conor Gallagher,3,2022-2023,22,eng ENG,Chelsea,eng Premier League,35,1621,18.0,18,17,2,3,1,4,3,0,0,0,MF,c2731c10,Full Starter
2613,Zakaria Aboukhlal,3,2023-2024,23,ma MAR,Toulouse,fr Ligue 1,13,754,8.4,9,4,0,3,0,3,2,1,1,0,MFFW,c2a6033c,Rotational Player
2614,Alberto Moleiro,3,2023-2024,19,es ESP,Las Palmas,es La Liga,28,1803,20.0,21,7,0,3,3,6,3,0,0,0,FWMF,c2c8897d,Rotational Player
2615,Yankuba Minteh,3,2024-2025,20,gm GAM,Brighton,eng Premier League,18,750,8.3,7,11,0,3,2,5,3,0,0,0,FWMF,c3cf087d,Bench Player
2616,Arnau Martinez,3,2022-2023,19,es ESP,Girona,es La Liga,33,2732,30.4,32,1,3,3,4,7,3,0,0,0,DF,c3e66ffe,Full Starter
2617,Dejan Ljubicic,3,2021-2022,23,at AUT,Köln,de Bundesliga,30,1969,21.9,22,8,0,3,1,4,3,0,0,0,MFFW,c455a2b2,Rotational Player
2618,Joakim Mæhle,3,2024-2025,27,dk DEN,Wolfsburg,de Bundesliga,14,1016,11.3,12,2,0,3,3,6,3,0,0,0,DF,c459a650,Rotational Player
2619,Joakim Mæhle,3,2022-2023,25,dk DEN,Atalanta,it Serie A,34,2209,24.5,25,9,2,3,3,6,3,0,0,0,DFMF,c459a650,Rotational Player
2620,Diego López,3,2024-2025,22,es ESP,Valencia,es La Liga,21,1541,17.1,19,2,0,3,3,6,3,0,0,0,MFFW,c487901c,Rotational Player
2621,Diego López,3,2023-2024,21,es ESP,Valencia,es La Liga,36,2656,29.5,30,6,0,3,6,9,3,0,0,0,MFFW,c487901c,Rotational Player
2622,Diego López,3,2022-2023,20,es ESP,Valencia,es La Liga,10,447,5.0,5,5,0,3,1,4,3,0,0,0,FWMF,c487901c,Rotational Player
2623,Michael Keane,3,2021-2022,28,eng ENG,Everton,eng Premier League,32,2792,31.0,31,1,4,3,2,5,3,0,0,0,DF,c5b7c315,Full Starter
2624,Michael Keane,3,2020-2021,27,eng ENG,Everton,eng Premier League,35,2991,33.2,33,2,2,3,1,4,3,0,0,0,DF,c5b7c315,Full Starter
2625,Reiss Nelson,3,2022-2023,22,eng ENG,Arsenal,eng Premier League,11,212,2.4,0,11,11,3,2,5,3,0,0,0,FW,c5bdb6e3,Bench Player
2626,Kobbie Mainoo,3,2023-2024,18,eng ENG,Manchester Utd,eng Premier League,24,1924,21.4,24,0,5,3,1,4,3,0,0,0,MF,c6220452,Rotational Player
2627,Saša Lukić,3,2020-2021,23,rs SRB,Torino,it Serie A,32,2106,23.4,24,8,3,3,0,3,3,0,0,0,MF,c6e8cf1f,Full Starter
2628,Rolando Mandragora,3,2023-2024,26,it ITA,Fiorentina,it Serie A,33,1588,17.6,16,17,3,3,3,6,3,0,0,0,MF,c7259b83,Rotational Player
2629,Rolando Mandragora,3,2020-2021,23,it ITA,2 Teams,it Serie A,27,1923,21.4,20,7,2,3,1,4,3,0,0,0,MF,c7259b83,Rotational Player
2630,Antonio Puertas,3,2020-2021,28,es ESP,Granada,es La Liga,35,2170,24.1,22,13,0,3,5,8,3,0,0,0,FWMF,c77a8043,Rotational Player
2631,Thomas Mangani,3,2020-2021,33,fr FRA,Angers,fr Ligue 1,35,2691,29.9,32,3,1,3,3,6,0,3,3,0,MF,c801616a,Full Starter
2632,Daniel James,3,2020-2021,22,wls WAL,Manchester Utd,eng Premier League,15,910,10.1,11,4,12,3,1,4,3,0,0,0,FW,c931d9f9,Rotational Player
2633,Luka Romero,3,2023-2024,18,ar ARG,2 Teams,2 Comps,17,526,5.8,5,12,21,3,0,3,3,0,0,0,FWMF,ca6edaa0,Bench Player
2634,Enis Bardhi,3,2021-2022,26,mk MKD,Levante,es La Liga,30,1701,18.9,17,13,2,3,3,6,1,2,2,0,MFFW,cac2537b,Rotational Player
2635,Patrick Wimmer,3,2021-2022,20,at AUT,Arminia,de Bundesliga,31,2052,22.8,27,4,2,3,6,9,3,0,0,0,FWMF,cb11b429,Rotational Player
2636,Hugo Mallo,3,2020-2021,29,es ESP,Celta Vigo,es La Liga,31,2602,28.9,30,1,1,3,1,4,3,0,0,0,DF,cb574619,Full Starter
2637,Roman Yaremchuk,3,2023-2024,27,ua UKR,Valencia,es La Liga,25,928,10.3,11,14,4,3,0,3,3,0,0,0,FW,cb641b9d,Rotational Player
2638,Paul Wanner,3,2024-2025,18,de GER,Heidenheim,de Bundesliga,19,1335,14.8,17,2,0,3,1,4,2,1,1,0,MFFW,cb64672e,Rotational Player
2639,Matthieu Udol,3,2023-2024,27,fr FRA,Metz,fr Ligue 1,30,2700,30.0,30,0,0,3,3,6,3,0,0,0,DF,cc41f558,Full Starter
2640,Leon Goretzka,3,2024-2025,29,de GER,Bayern Munich,de Bundesliga,14,716,8.0,7,7,4,3,1,4,3,0,0,0,MFDF,cc86b9a3,Rotational Player
2641,Leon Goretzka,3,2022-2023,27,de GER,Bayern Munich,de Bundesliga,27,1728,19.2,22,5,1,3,2,5,3,0,0,0,MF,cc86b9a3,Rotational Player
2642,Leon Goretzka,3,2021-2022,26,de GER,Bayern Munich,de Bundesliga,19,1396,15.5,19,0,1,3,3,6,3,0,0,0,MF,cc86b9a3,Rotational Player
2643,Largie Ramazani,3,2023-2024,22,be BEL,Almería,es La Liga,29,1555,17.3,16,13,2,3,5,8,3,0,0,0,FWMF,cc9256ef,Rotational Player
2644,Largie Ramazani,3,2022-2023,21,be BEL,Almería,es La Liga,33,1403,15.6,13,20,4,3,1,4,3,0,1,1,FWMF,cc9256ef,Rotational Player
2645,Sven Botman,3,2021-2022,21,nl NED,Lille,fr Ligue 1,25,2250,25.0,25,0,1,3,1,4,3,0,0,0,DF,ccce7025,Rotational Player
2646,Hakan Çalhanoğlu,3,2022-2023,28,tr TUR,Inter,it Serie A,33,2363,26.3,28,5,2,3,6,9,2,1,1,0,MF,cd0fa27b,Full Starter
2647,Trent Alexander-Arnold,3,2023-2024,24,eng ENG,Liverpool,eng Premier League,28,2155,23.9,25,3,0,3,4,7,3,0,0,0,DF,cd1acf9d,Rotational Player
2648,Dion Moise Sahi,3,2023-2024,21,ci CIV,Strasbourg,fr Ligue 1,18,628,7.0,7,11,4,3,1,4,3,0,0,0,MFFW,cdc4458b,Bench Player
2649,Roberto Gagliardini,3,2020-2021,26,it ITA,Inter,it Serie A,28,1232,13.7,14,14,8,3,2,5,3,0,0,0,MF,ce30bfc8,Rotational Player
2650,Kurt Zouma,3,2023-2024,28,fr FRA,West Ham,eng Premier League,33,2838,31.5,32,1,1,3,0,3,3,0,0,0,DF,ce4246f5,Full Starter
2651,Elif Elmas,3,2021-2022,21,mk MKD,Napoli,it Serie A,37,1620,18.0,12,25,0,3,4,7,3,0,0,0,FWMF,cf007308,Rotational Player
2652,Marc Guéhi,3,2024-2025,24,eng ENG,Crystal Palace,eng Premier League,22,1980,22.0,22,0,0,3,1,4,3,0,0,0,DF,d0706b27,Rotational Player
2653,Mikel Merino,3,2021-2022,25,es ESP,Real Sociedad,es La Liga,34,2890,32.1,33,1,0,3,2,5,3,0,0,0,MF,d080ed5e,Full Starter
2654,Armin Gigovic,3,2024-2025,22,ba BIH,Holstein Kiel,de Bundesliga,18,948,10.5,11,7,1,3,0,3,3,0,0,0,MF,d0a0858e,Rotational Player
2655,Abdón Prats,3,2021-2022,28,es ESP,Mallorca,es La Liga,23,641,7.1,6,17,14,3,0,3,3,0,0,0,FW,d1b060e2,Bench Player
2656,Morten Thorsby,3,2021-2022,25,no NOR,Sampdoria,it Serie A,35,2943,32.7,35,0,0,3,1,4,3,0,0,0,MF,d1b49282,Full Starter
2657,Morten Thorsby,3,2020-2021,24,no NOR,Sampdoria,it Serie A,33,2648,29.4,29,4,1,3,1,4,3,0,0,0,MF,d1b49282,Full Starter
2658,Mouctar Diakhaby,3,2022-2023,25,gn GUI,Valencia,es La Liga,29,2446,27.2,28,1,4,3,0,3,3,0,0,0,DF,d2110326,Full Starter
2659,Ben Chilwell,3,2021-2022,24,eng ENG,Chelsea,eng Premier League,7,542,6.0,6,1,6,3,1,4,3,0,0,0,DF,d2424d1b,Rotational Player
2660,Ben Chilwell,3,2020-2021,23,eng ENG,Chelsea,eng Premier League,27,2286,25.4,27,0,7,3,5,8,3,0,0,0,DF,d2424d1b,Rotational Player
2661,Daniele Verde,3,2022-2023,26,it ITA,Spezia,it Serie A,25,998,11.1,11,14,7,3,0,3,2,1,1,0,FWMF,d3298c99,Rotational Player
2662,Stephan El Shaarawy,3,2024-2025,31,it ITA,Roma,it Serie A,18,784,8.7,9,9,2,3,3,6,3,0,0,0,DFMF,d3aaad90,Rotational Player
2663,Stephan El Shaarawy,3,2023-2024,30,it ITA,Roma,it Serie A,33,1738,19.3,19,14,5,3,4,7,3,0,0,0,FWDF,d3aaad90,Rotational Player
2664,Stephan El Shaarawy,3,2021-2022,28,it ITA,Roma,it Serie A,27,1055,11.7,8,19,4,3,0,3,3,0,0,0,FWDF,d3aaad90,Rotational Player
2665,Duván Zapata,3,2024-2025,33,co COL,Torino,it Serie A,7,587,6.5,7,0,0,3,0,3,3,0,0,0,FW,d3de9af0,Rotational Player
2666,Theo Hernández,3,2024-2025,26,fr FRA,Milan,it Serie A,18,1399,15.5,15,3,1,3,2,5,3,0,1,1,DF,d4c9725f,Full Starter
2667,Amin Sarr,3,2024-2025,23,se SWE,Hellas Verona,it Serie A,15,633,7.0,8,7,4,3,0,3,3,0,0,0,FW,d5326924,Bench Player
2668,Johannes Eggestein,3,2024-2025,26,de GER,St. Pauli,de Bundesliga,17,1375,15.3,17,0,0,3,4,7,2,1,2,1,FW,d571df78,Rotational Player
2669,Marquinhos,3,2020-2021,26,br BRA,Paris S-G,fr Ligue 1,25,2128,23.6,24,1,2,3,1,4,3,0,0,0,DF,d5f2f82b,Full Starter
2670,Matthijs de Ligt,3,2022-2023,22,nl NED,Bayern Munich,de Bundesliga,31,2403,26.7,27,4,1,3,1,4,3,0,0,0,DF,d6e53a3a,Full Starter
2671,Matthijs de Ligt,3,2021-2022,21,nl NED,Juventus,it Serie A,31,2674,29.7,29,2,6,3,1,4,3,0,0,0,DF,d6e53a3a,Full Starter
2672,Tobias Kempe,3,2023-2024,34,de GER,Darmstadt 98,de Bundesliga,24,1350,15.0,15,9,5,3,2,5,0,3,3,0,MF,d7cdfd81,Rotational Player
2673,Guillermo Maripán,3,2022-2023,28,cl CHI,Monaco,fr Ligue 1,26,2157,24.0,25,1,5,3,0,3,3,0,0,0,DF,d9764034,Rotational Player
2674,Giacomo Bonaventura,3,2020-2021,30,it ITA,Fiorentina,it Serie A,34,2256,25.1,27,7,0,3,2,5,3,0,0,0,MF,d995ed27,Full Starter
2675,Jordan Ayew,3,2021-2022,29,gh GHA,Crystal Palace,eng Premier League,31,2019,22.4,23,8,6,3,3,6,3,0,0,0,FW,da052c14,Rotational Player
2676,Kalidou Koulibaly,3,2021-2022,30,sn SEN,Napoli,it Serie A,27,2405,26.7,27,0,0,3,1,4,3,0,0,0,DF,da974c7b,Full Starter
2677,Franck Honorat,3,2023-2024,26,fr FRA,Gladbach,de Bundesliga,32,2345,26.1,28,4,0,3,9,12,3,0,0,0,DFFW,db7849ca,Full Starter
2678,Adri Embarba,3,2023-2024,31,es ESP,Almería,es La Liga,36,2476,27.5,29,7,2,3,2,5,2,1,1,0,FWMF,db8f0eba,Rotational Player
2679,Junya Ito,3,2023-2024,30,jp JPN,Reims,fr Ligue 1,31,2714,30.2,31,0,0,3,7,10,3,0,0,0,FWMF,dbd3a428,Full Starter
2680,Jadon Sancho,3,2021-2022,21,eng ENG,Manchester Utd,eng Premier League,29,1900,21.1,20,9,3,3,3,6,3,0,0,0,FWMF,dbf053da,Rotational Player
2681,Álex Berenguer,3,2021-2022,26,es ESP,Athletic Club,es La Liga,34,2168,24.1,24,10,2,3,6,9,3,0,1,1,MF,dc1c2fce,Rotational Player
2682,Leonardo Bittencourt,3,2022-2023,28,de GER,Werder Bremen,de Bundesliga,25,1629,18.1,22,3,1,3,2,5,3,0,0,0,MFDF,dc62fbee,Rotational Player
2683,Amine Adli,3,2021-2022,21,ma MAR,Leverkusen,de Bundesliga,25,1256,14.0,13,12,0,3,2,5,3,0,0,0,FWMF,dcfb17f4,Rotational Player
2684,Henrikh Mkhitaryan,3,2022-2023,33,am ARM,Inter,it Serie A,31,1986,22.1,24,7,1,3,2,5,3,0,0,0,MF,dd0daf32,Full Starter
2685,Mbaye Diagne,3,2020-2021,28,sn SEN,West Brom,eng Premier League,16,1189,13.2,14,2,2,3,2,5,3,0,0,0,FW,dda3969e,Rotational Player
2686,Jacob Murphy,3,2024-2025,29,eng ENG,Newcastle Utd,eng Premier League,20,1255,13.9,16,4,2,3,7,10,3,0,0,0,FW,de112b84,Rotational Player
2687,Jacob Murphy,3,2023-2024,28,eng ENG,Newcastle Utd,eng Premier League,21,1189,13.2,14,7,5,3,7,10,3,0,0,0,FWDF,de112b84,Rotational Player
2688,Gift Orban,3,2024-2025,22,ng NGA,2 Teams,2 Comps,6,318,3.5,3,3,3,3,0,3,3,0,0,0,FWDF,de17db90,Bench Player
2689,William Carvalho,3,2022-2023,30,pt POR,Betis,es La Liga,33,2438,27.1,31,2,0,3,1,4,3,0,0,0,MF,dee86451,Full Starter
2690,Christian Nørgaard,3,2021-2022,27,dk DEN,Brentford,eng Premier League,35,3054,33.9,35,0,0,3,4,7,3,0,0,0,MF,df0a4c90,Full Starter
2691,Antoine Griezmann,3,2021-2022,30,fr FRA,2 Teams,es La Liga,29,1958,21.8,24,5,1,3,4,7,3,0,0,0,FW,df69b544,Full Starter
2692,Marco Brescianini,3,2024-2025,24,it ITA,Atalanta,it Serie A,16,566,6.3,5,11,2,3,2,5,3,0,0,0,MF,dfd56738,Rotational Player
2693,Leandro Paredes,3,2023-2024,29,ar ARG,Roma,it Serie A,34,2634,29.3,32,2,0,3,5,8,0,3,3,0,MF,dff153a4,Full Starter
2694,Virgil van Dijk,3,2022-2023,31,nl NED,Liverpool,eng Premier League,32,2835,31.5,32,0,1,3,1,4,3,0,0,0,DF,e06683ca,Full Starter
2695,Virgil van Dijk,3,2021-2022,30,nl NED,Liverpool,eng Premier League,34,3060,34.0,34,0,1,3,1,4,3,0,0,0,DF,e06683ca,Full Starter
2696,Fabian Klos,3,2021-2022,33,de GER,Arminia,de Bundesliga,25,1420,15.8,14,11,1,3,1,4,1,2,2,0,FW,e21042ae,Rotational Player
2697,Marcelo,3,2020-2021,33,br BRA,Lyon,fr Ligue 1,34,2907,32.3,34,0,0,3,0,3,3,0,0,0,DF,e3d0b0c4,Full Starter
2698,Jaidon Anthony,3,2022-2023,22,eng ENG,Bournemouth,eng Premier League,30,1257,14.0,11,19,8,3,1,4,3,0,0,0,MFFW,e4238fb1,Rotational Player
2699,Ethan Pinnock,3,2022-2023,29,jm JAM,Brentford,eng Premier League,30,2700,30.0,30,0,0,3,0,3,3,0,0,0,DF,e541326e,Full Starter
2700,Julien Ponceau,3,2023-2024,22,fr FRA,Lorient,fr Ligue 1,32,2244,24.9,27,5,2,3,2,5,3,0,0,0,MF,e546b2e3,Full Starter
2701,Kevin Stöger,3,2020-2021,26,at AUT,Mainz 05,de Bundesliga,19,538,6.0,4,15,9,3,0,3,3,0,0,0,MFFW,e5649a78,Rotational Player
2702,Luca Waldschmidt,3,2023-2024,27,de GER,Köln,de Bundesliga,22,1146,12.7,14,8,0,3,0,3,3,0,1,1,MFFW,e5a35ae9,Bench Player
2703,Musa Barrow,3,2022-2023,23,gm GAM,Bologna,it Serie A,32,1960,21.8,26,6,2,3,8,11,3,0,0,0,FWMF,e5bf73f3,Full Starter
2704,Linton Maina,3,2022-2023,23,de GER,Köln,de Bundesliga,33,2239,24.9,27,6,1,3,7,10,3,0,0,0,FWMF,e5d85da8,Full Starter
2705,Granit Xhaka,3,2023-2024,30,ch SUI,Leverkusen,de Bundesliga,33,2821,31.3,32,1,0,3,0,3,3,0,0,0,MF,e61b8aee,Full Starter
2706,Patrick Dorgu,3,2024-2025,19,dk DEN,Lecce,it Serie A,21,1840,20.4,21,0,0,3,1,4,3,0,0,0,DFFW,e6536124,Rotational Player
2707,Gonçalo Guedes,3,2023-2024,26,pt POR,Villarreal,es La Liga,17,951,10.6,9,8,1,3,2,5,3,0,0,0,FWMF,e6bc67d7,Rotational Player
2708,Lorenzo De Silvestri,3,2021-2022,33,it ITA,Bologna,it Serie A,31,2294,25.5,27,4,1,3,2,5,3,0,0,0,DF,e74f0e59,Full Starter
2709,Moussa Dembélé,3,2022-2023,26,fr FRA,Lyon,fr Ligue 1,23,877,9.7,8,15,10,3,0,3,3,0,0,0,FWMF,e7986081,Rotational Player
2710,Cyle Larin,3,2023-2024,28,ca CAN,Mallorca,es La Liga,35,1823,20.3,20,15,2,3,2,5,3,0,0,0,FW,e7af9060,Rotational Player
2711,João Pedro,3,2021-2022,19,br BRA,Watford,eng Premier League,28,1644,18.3,15,13,1,3,1,4,3,0,0,0,FWMF,e8832875,Rotational Player
2712,Kiké,3,2023-2024,33,es ESP,Alavés,es La Liga,33,1423,15.8,15,18,4,3,2,5,3,0,1,1,FWMF,e897d8ba,Rotational Player
2713,Billy Sharp,3,2020-2021,34,eng ENG,Sheffield Utd,eng Premier League,16,735,8.2,7,9,9,3,0,3,1,2,2,0,FW,e8c9f4e9,Bench Player
2714,Yorbe Vertessen,3,2023-2024,22,be BEL,Union Berlin,de Bundesliga,13,593,6.6,7,6,2,3,2,5,3,0,0,0,FWMF,e8ef59da,Bench Player
2715,Jack Hinshelwood,3,2023-2024,18,eng ENG,Brighton,eng Premier League,12,869,9.7,8,4,4,3,0,3,3,0,0,0,DF,e98211e7,Bench Player
2716,Remi Oudin,3,2023-2024,26,fr FRA,Lecce,it Serie A,31,1819,20.2,21,10,5,3,2,5,3,0,0,0,MFFW,ea02beaf,Rotational Player
2717,Remi Oudin,3,2022-2023,25,fr FRA,Lecce,it Serie A,31,1321,14.7,12,19,3,3,0,3,3,0,0,0,FWMF,ea02beaf,Rotational Player
2718,Valère Germain,3,2020-2021,30,fr FRA,Marseille,fr Ligue 1,24,857,9.5,6,18,12,3,0,3,3,0,0,0,FWMF,ea0ff634,Rotational Player
2719,Germán Sánchez,3,2020-2021,33,es ESP,Granada,es La Liga,34,2638,29.3,29,5,1,3,1,4,3,0,0,0,DF,ea9b2ef9,Full Starter
2720,Moanes Dabbur,3,2021-2022,29,il ISR,Hoffenheim,de Bundesliga,27,1310,14.6,17,10,5,3,4,7,3,0,0,0,FWMF,eac044ad,Rotational Player
2721,Juan Miranda,3,2022-2023,22,es ESP,Betis,es La Liga,21,1472,16.4,16,5,16,3,2,5,3,0,0,0,DF,ead61f73,Rotational Player
2722,Luis Muriel,3,2022-2023,31,co COL,Atalanta,it Serie A,29,1073,11.9,10,19,2,3,3,6,2,1,1,0,FWMF,eb2fe5b6,Rotational Player
2723,Fidel,3,2022-2023,32,es ESP,Elche,es La Liga,27,1714,19.0,21,6,1,3,2,5,2,1,1,0,MFFW,eb82b6f1,Full Starter
2724,Filip Đuričić,3,2022-2023,30,rs SRB,Sampdoria,it Serie A,32,2171,24.1,27,5,1,3,0,3,3,0,0,0,MFFW,eccbe56a,Full Starter
2725,Florian Tardieu,3,2022-2023,30,fr FRA,Troyes,fr Ligue 1,15,1009,11.2,11,4,1,3,0,3,0,3,3,0,MF,ed39121c,Rotational Player
2726,Beto,3,2023-2024,25,gw GNB,2 Teams,2 Comps,31,1025,11.4,10,21,2,3,0,3,3,0,1,1,FW,ed5c0319,Rotational Player
2727,Fran Beltrán,3,2020-2021,21,es ESP,Celta Vigo,es La Liga,32,1399,15.5,13,19,6,3,0,3,3,0,0,0,MFFW,ed5c5fa3,Rotational Player
2728,Maximilian Wittek,3,2023-2024,27,de GER,Bochum,de Bundesliga,21,1070,11.9,13,8,11,3,1,4,3,0,0,0,DFFW,edb2712b,Rotational Player
2729,Vanderson,3,2023-2024,22,br BRA,Monaco,fr Ligue 1,20,1641,18.2,20,0,5,3,1,4,3,0,0,0,DF,ee45fd85,Rotational Player
2730,Ricardo Mangas,3,2021-2022,23,pt POR,Bordeaux,fr Ligue 1,29,2353,26.1,27,2,3,3,1,4,3,0,0,0,DF,eef2d8ce,Full Starter
2731,Abdoulaye Touré,3,2024-2025,30,gn GUI,Le Havre,fr Ligue 1,16,1334,14.8,15,1,0,3,1,4,0,3,3,0,MF,ef7cd87a,Rotational Player
2732,David López,3,2023-2024,33,es ESP,Girona,es La Liga,25,1965,21.8,25,0,2,3,0,3,3,0,0,0,DF,f03f284b,Rotational Player
2733,David López,3,2022-2023,32,es ESP,Girona,es La Liga,20,1652,18.4,19,1,7,3,1,4,3,0,0,0,DF,f03f284b,Rotational Player
2734,Nicolás Tagliafico,3,2023-2024,30,ar ARG,Lyon,fr Ligue 1,25,2123,23.6,25,0,0,3,1,4,3,0,0,0,DF,f0661424,Rotational Player
2735,Arnaut Danjuma,3,2024-2025,27,nl NED,2 Teams,es La Liga,18,1000,11.1,12,6,0,3,0,3,3,0,0,0,FW,f08490a6,Rotational Player
2736,Arnaut Danjuma,3,2022-2023,25,nl NED,2 Teams,2 Comps,19,648,7.2,7,12,10,3,0,3,2,1,1,0,FWMF,f08490a6,Rotational Player
2737,Hélder Costa,3,2020-2021,26,ao ANG,Leeds United,eng Premier League,22,1156,12.8,13,9,10,3,3,6,3,0,0,0,MFFW,f13d02a6,Rotational Player
2738,Naby Keïta,3,2021-2022,26,gn GUI,Liverpool,eng Premier League,23,1173,13.0,14,9,6,3,1,4,3,0,0,0,MF,f25c8e3a,Rotational Player
2739,Xeka,3,2021-2022,26,pt POR,Lille,fr Ligue 1,23,1619,18.0,19,4,4,3,0,3,3,0,0,0,MF,f3600c02,Rotational Player
2740,Toni Martínez,3,2024-2025,27,es ESP,Alavés,es La Liga,15,545,6.1,5,10,3,3,0,3,3,0,0,0,FW,f3945e07,Bench Player
2741,Niels Nkounkou,3,2023-2024,22,fr FRA,Eint Frankfurt,de Bundesliga,29,1309,14.5,13,16,2,3,2,5,3,0,0,0,DFMF,f5b281e7,Rotational Player
2742,Keven Schlotterbeck,3,2024-2025,27,de GER,Augsburg,de Bundesliga,14,1054,11.7,13,1,0,3,1,4,3,0,0,0,DF,f6bdc830,Rotational Player
2743,Viktor Tsyhankov,3,2022-2023,24,ua UKR,Girona,es La Liga,19,1489,16.5,17,2,2,3,6,9,3,0,0,0,MF,f7e87032,Rotational Player
2744,Takumi Minamino,3,2021-2022,26,jp JPN,Liverpool,eng Premier League,11,186,2.1,1,10,15,3,0,3,3,0,0,0,FWMF,f833a830,Rotational Player
2745,Takumi Minamino,3,2020-2021,25,jp JPN,2 Teams,eng Premier League,19,1004,11.2,11,8,16,3,0,3,3,0,0,0,MF,f833a830,Rotational Player
2746,Mohamed Ali Cho,3,2024-2025,20,fr FRA,Nice,fr Ligue 1,15,963,10.7,13,2,0,3,2,5,3,0,0,0,FWMF,f8405304,Rotational Player
2747,Cedric Teuchert,3,2020-2021,23,de GER,Union Berlin,de Bundesliga,24,754,8.4,5,19,7,3,1,4,3,0,0,0,FWMF,f956479d,Bench Player
2748,Marco Richter,3,2020-2021,22,de GER,Augsburg,de Bundesliga,29,1416,15.7,16,13,1,3,1,4,3,0,0,0,FWMF,f972644c,Rotational Player
2749,Hicham Boudaoui,3,2021-2022,21,dz ALG,Nice,fr Ligue 1,29,1621,18.0,21,8,5,3,2,5,3,0,0,0,MF,f9d5908e,Rotational Player
2750,Hicham Boudaoui,3,2020-2021,20,dz ALG,Nice,fr Ligue 1,25,1736,19.3,22,3,1,3,2,5,3,0,0,0,MF,f9d5908e,Rotational Player
2751,Marius Wolf,3,2021-2022,26,de GER,Dortmund,de Bundesliga,27,1321,14.7,15,12,2,3,1,4,3,0,0,0,DFFW,fa661778,Rotational Player
2752,Khalil Fayad,3,2023-2024,19,fr FRA,Montpellier,fr Ligue 1,23,1025,11.4,11,12,7,3,0,3,3,0,0,0,FWMF,faf00ab8,Rotational Player
2753,Mama Samba Baldé,3,2021-2022,25,gw GNB,Troyes,fr Ligue 1,30,1717,19.1,20,10,0,3,2,5,3,0,1,1,MFFW,fb14aa28,Rotational Player
2754,Aïssa Mandi,3,2020-2021,28,dz ALG,Betis,es La Liga,28,2392,26.6,27,1,5,3,1,4,3,0,0,0,DF,fbd6378b,Full Starter
2755,Dwight McNeil,3,2024-2025,24,eng ENG,Everton,eng Premier League,13,1140,12.7,13,0,0,3,3,6,3,0,0,0,MFFW,fc15fb84,Rotational Player
2756,Dwight McNeil,3,2023-2024,23,eng ENG,Everton,eng Premier League,35,2892,32.1,33,2,0,3,6,9,3,0,0,0,MFFW,fc15fb84,Rotational Player
2757,Óscar Trejo,3,2022-2023,34,ar ARG,Rayo Vallecano,es La Liga,34,2145,23.8,28,6,0,3,4,7,2,1,2,1,MFFW,fc647b34,Full Starter
2758,Óscar Trejo,3,2021-2022,33,ar ARG,Rayo Vallecano,es La Liga,32,2007,22.3,24,8,1,3,9,12,0,3,3,0,MF,fc647b34,Full Starter
2759,Ricard Sánchez,3,2023-2024,23,es ESP,Granada,es La Liga,33,2295,25.5,25,8,4,3,0,3,3,0,0,0,DF,fce521d7,Rotational Player
2760,Lucas Vázquez,3,2023-2024,32,es ESP,Real Madrid,es La Liga,29,1419,15.8,14,15,9,3,6,9,3,0,0,0,DF,fd51b456,Rotational Player
2761,Lucas Vázquez,3,2021-2022,30,es ESP,Real Madrid,es La Liga,29,1833,20.4,20,9,8,3,0,3,3,0,0,0,DF,fd51b456,Rotational Player
2762,Jan Thielmann,3,2021-2022,19,de GER,Köln,de Bundesliga,29,1192,13.2,10,19,0,3,3,6,3,0,0,0,MFFW,fd53759d,Rotational Player
2763,Kevin Sessa,3,2023-2024,23,de GER,Heidenheim,de Bundesliga,30,1011,11.2,7,23,2,3,0,3,3,0,0,0,MFFW,fd82af8c,Bench Player
2764,Abdallah Sima,3,2024-2025,23,sn SEN,Brest,fr Ligue 1,14,565,6.3,6,8,0,3,2,5,3,0,0,0,FW,fdbde523,Rotational Player
2765,Cala,3,2020-2021,30,es ESP,Cádiz,es La Liga,28,2272,25.2,26,2,1,3,0,3,3,0,0,0,DF,fe05804b,Full Starter
2766,Pape Matar Sarr,3,2023-2024,20,sn SEN,Tottenham,eng Premier League,34,2069,23.0,27,7,0,3,3,6,3,0,0,0,MF,feb5d972,Rotational Player
2767,Pape Matar Sarr,3,2020-2021,17,sn SEN,Metz,fr Ligue 1,22,1594,17.7,18,4,9,3,0,3,3,0,0,0,MF,feb5d972,Rotational Player
2768,Robert Skov,3,2023-2024,27,dk DEN,Hoffenheim,de Bundesliga,25,1260,14.0,14,11,6,3,4,7,3,0,0,0,DFFW,ff98492b,Rotational Player
2769,Robert Skov,3,2022-2023,26,dk DEN,Hoffenheim,de Bundesliga,23,1349,15.0,16,7,2,3,2,5,1,2,2,0,DF,ff98492b,Rotational Player
2770,Islam Slimani,3,2020-2021,32,dz ALG,2 Teams,2 Comps,19,599,6.7,4,15,0,3,1,4,3,0,0,0,FW,ffec9769,Bench Player
2771,Jeremy Doku,3,2024-2025,22,be BEL,Manchester City,eng Premier League,15,789,8.8,9,6,4,3,4,7,3,0,0,0,FWMF,fffea3e5,Rotational Player
2772,Leandro Barreiro Martins,2,2020-2021,20,lu LUX,Mainz 05,de Bundesliga,29,2303,25.6,27,2,4,2,2,4,2,0,0,0,MF,00242b75,Full Starter
2773,Tete Morente,2,2020-2021,23,es ESP,Elche,es La Liga,30,2019,22.4,23,7,4,2,5,7,2,0,0,0,MFFW,004d185e,Rotational Player
2774,Zinedine Ferhat,2,2024-2025,31,dz ALG,Angers,fr Ligue 1,11,327,3.6,2,9,2,2,0,2,2,0,0,0,FW,005c0807,Rotational Player
2775,Lucas Da Cunha,2,2021-2022,20,fr FRA,2 Teams,fr Ligue 1,25,1229,13.7,16,9,10,2,1,3,2,0,0,0,MF,007faf7a,Rotational Player
2776,Konstantinos Mavropanos,2,2022-2023,24,gr GRE,Stuttgart,de Bundesliga,28,2286,25.4,26,2,0,2,1,3,2,0,0,0,DF,00963611,Full Starter
2777,Julian Ryerson,2,2021-2022,23,no NOR,Union Berlin,de Bundesliga,28,1429,15.9,13,15,3,2,0,2,2,0,0,0,DF,009a4f60,Rotational Player
2778,Hugo Larsson,2,2023-2024,19,se SWE,Eint Frankfurt,de Bundesliga,29,1886,21.0,21,8,1,2,1,3,2,0,0,0,MF,00c9a283,Rotational Player
2779,Hugo Larsson,2,2024-2025,20,se SWE,Eint Frankfurt,de Bundesliga,18,1302,14.5,15,3,0,2,0,2,2,0,0,0,MF,00c9a283,Rotational Player
2780,Selim Amallah,2,2022-2023,25,ma MAR,Valladolid,es La Liga,7,267,3.0,3,4,2,2,1,3,2,0,0,0,MFFW,00eba9c9,Bench Player
2781,Selim Amallah,2,2024-2025,27,ma MAR,Valladolid,es La Liga,14,829,9.2,11,3,2,2,1,3,1,1,1,0,MFFW,00eba9c9,Bench Player
2782,Anthony Caci,2,2022-2023,25,fr FRA,Mainz 05,de Bundesliga,31,2033,22.6,23,8,3,2,1,3,2,0,0,0,DF,0118c54c,Full Starter
2783,Anthony Caci,2,2023-2024,26,fr FRA,Mainz 05,de Bundesliga,31,2486,27.6,29,2,0,2,3,5,2,0,0,0,DF,0118c54c,Full Starter
2784,Felix Afena-Gyan,2,2021-2022,18,gh GHA,Roma,it Serie A,17,668,7.4,6,11,8,2,0,2,2,0,0,0,FWMF,0154d290,Bench Player
2785,Valentino Lazaro,2,2020-2021,24,at AUT,Gladbach,de Bundesliga,22,1240,13.8,13,9,1,2,0,2,2,0,0,0,DFFW,016ff750,Rotational Player
2786,Robin Hack,2,2024-2025,25,de GER,Gladbach,de Bundesliga,18,1040,11.6,13,5,1,2,3,5,2,0,0,0,FW,0174ba21,Rotational Player
2787,Sebastiaan Bornauw,2,2024-2025,25,be BEL,Wolfsburg,de Bundesliga,10,662,7.4,7,3,3,2,0,2,2,0,0,0,DF,01834aa0,Bench Player
2788,Mohamed Lamine Bayo,2,2024-2025,26,gn GUI,Lille,fr Ligue 1,12,309,3.4,4,8,6,2,1,3,2,0,0,0,FW,01870104,Rotational Player
2789,Joe Gelhardt,2,2021-2022,19,eng ENG,Leeds United,eng Premier League,20,746,8.3,5,15,11,2,2,4,2,0,0,0,FWMF,01962d0d,Bench Player
2790,Weston McKennie,2,2024-2025,25,us USA,Juventus,it Serie A,16,1050,11.7,12,4,3,2,3,5,2,0,0,0,MFDF,01c3aff5,Rotational Player
2791,Ángel Correa,2,2024-2025,29,ar ARG,Atlético Madrid,es La Liga,19,556,6.2,3,16,2,2,1,3,2,0,0,0,FWMF,01eb744d,Rotational Player
2792,Antonín Barák,2,2022-2023,27,cz CZE,2 Teams,it Serie A,31,1824,20.3,21,10,4,2,0,2,2,0,0,0,MF,01efac19,Rotational Player
2793,Antonín Barák,2,2023-2024,28,cz CZE,Fiorentina,it Serie A,21,808,9.0,8,13,14,2,3,5,2,0,0,0,MFFW,01efac19,Rotational Player
2794,Joshua Zirkzee,2,2022-2023,21,nl NED,2 Teams,2 Comps,19,822,9.1,5,14,11,2,2,4,2,0,0,0,FW,028e70b9,Rotational Player
2795,Abdoulaye Doucouré,2,2020-2021,27,ml MLI,Everton,eng Premier League,29,2443,27.1,29,0,1,2,3,5,2,0,0,0,MF,02b29014,Full Starter
2796,Abdoulaye Doucouré,2,2021-2022,28,ml MLI,Everton,eng Premier League,30,2537,28.2,29,1,1,2,4,6,2,0,0,0,MF,02b29014,Full Starter
2797,Marcos Llorente,2,2024-2025,29,es ESP,Atlético Madrid,es La Liga,16,1050,11.7,12,4,0,2,2,4,2,0,0,0,DFMF,02c15616,Rotational Player
2798,Manuel Lazzari,2,2020-2021,26,it ITA,Lazio,it Serie A,32,2613,29.0,30,2,0,2,5,7,2,0,0,0,DF,02caf6e0,Rotational Player
2799,Jofre,2,2024-2025,23,es ESP,Espanyol,es La Liga,20,1299,14.4,16,4,0,2,3,5,2,0,0,0,MFFW,030ef8d6,Rotational Player
2800,Ezri Konsa,2,2021-2022,23,eng ENG,Aston Villa,eng Premier League,29,2477,27.5,29,0,3,2,0,2,2,0,0,0,DF,0313a347,Full Starter
2801,Ezri Konsa,2,2020-2021,22,eng ENG,Aston Villa,eng Premier League,36,3196,35.5,35,1,0,2,0,2,2,0,0,0,DF,0313a347,Full Starter
2802,Renato Sanches,2,2022-2023,24,pt POR,Paris S-G,fr Ligue 1,23,717,8.0,6,17,1,2,0,2,2,0,0,0,MF,032f894e,Rotational Player
2803,Renato Sanches,2,2021-2022,23,pt POR,Lille,fr Ligue 1,25,1651,18.3,20,5,0,2,5,7,2,0,0,0,MFFW,032f894e,Rotational Player
2804,Rubén Alcaraz,2,2021-2022,30,es ESP,Cádiz,es La Liga,14,1105,12.3,12,2,0,2,0,2,2,0,0,0,MF,036bba5f,Rotational Player
2805,Badredine Bouanani,2,2024-2025,19,dz ALG,Nice,fr Ligue 1,17,664,7.4,6,11,1,2,0,2,2,0,0,0,MFFW,0400dd2f,Bench Player
2806,Eddie Salcedo,2,2020-2021,18,it ITA,Hellas Verona,it Serie A,21,755,8.4,7,14,12,2,0,2,2,0,0,0,MFFW,0489bb30,Bench Player
2807,Aleix Vidal,2,2021-2022,31,es ESP,Espanyol,es La Liga,31,1901,21.1,21,10,1,2,0,2,2,0,0,0,DFMF,04965583,Rotational Player
2808,David Alaba,2,2020-2021,28,at AUT,Bayern Munich,de Bundesliga,32,2675,29.7,30,2,0,2,4,6,2,0,0,0,DFMF,05439de2,Full Starter
2809,David Alaba,2,2021-2022,29,at AUT,Real Madrid,es La Liga,30,2642,29.4,30,0,0,2,3,5,2,0,0,0,DF,05439de2,Full Starter
2810,Iago,2,2021-2022,24,br BRA,Augsburg,de Bundesliga,28,2174,24.2,26,2,0,2,5,7,2,0,0,0,DF,054849d2,Full Starter
2811,Óscar Mingueza,2,2020-2021,21,es ESP,Barcelona,es La Liga,27,1901,21.1,23,4,5,2,2,4,2,0,0,0,DF,056269d7,Rotational Player
2812,Óscar Mingueza,2,2023-2024,24,es ESP,Celta Vigo,es La Liga,38,2998,33.3,33,5,0,2,2,4,2,0,0,0,DFMF,056269d7,Rotational Player
2813,Óscar Mingueza,2,2024-2025,25,es ESP,Celta Vigo,es La Liga,19,1498,16.6,18,1,0,2,5,7,2,0,0,0,MFDF,056269d7,Rotational Player
2814,Christopher Trimmel,2,2021-2022,34,at AUT,Union Berlin,de Bundesliga,25,1990,22.1,23,2,8,2,0,2,2,0,0,0,DFFW,056d2d95,Rotational Player
2815,Tanguy Coulibaly,2,2020-2021,19,fr FRA,Stuttgart,de Bundesliga,31,1506,16.7,17,14,1,2,1,3,2,0,0,0,DFFW,05ba9d7c,Bench Player
2816,Cameron Archer,2,2024-2025,23,eng ENG,Southampton,eng Premier League,21,1047,11.6,10,11,2,2,0,2,2,0,1,1,FW,05e8ca6d,Rotational Player
2817,Jonathan Burkardt,2,2020-2021,20,de GER,Mainz 05,de Bundesliga,29,1373,15.3,16,13,2,2,0,2,2,0,0,0,FWMF,05f99a4a,Rotational Player
2818,Nemanja Radonjić,2,2022-2023,26,rs SRB,Torino,it Serie A,28,1461,16.2,16,12,2,2,2,4,2,0,0,0,MFFW,0630eb63,Rotational Player
2819,Benoît Badiashile,2,2020-2021,19,fr FRA,Monaco,fr Ligue 1,35,2870,31.9,32,3,3,2,1,3,2,0,0,0,DF,06df8256,Full Starter
2820,Sergi Darder,2,2023-2024,29,es ESP,Mallorca,es La Liga,36,2157,24.0,21,15,0,2,5,7,2,0,0,0,MF,070a3904,Full Starter
2821,Gaetano Castrovilli,2,2022-2023,25,it ITA,Fiorentina,it Serie A,15,718,8.0,7,8,5,2,1,3,2,0,0,0,MF,0728bebe,Rotational Player
2822,Rhys Healey,2,2022-2023,27,wls WAL,Toulouse,fr Ligue 1,4,64,0.7,0,4,0,2,0,2,2,0,0,0,FW,07ace8c3,Bench Player
2823,Anthony Losilla,2,2021-2022,35,fr FRA,Bochum,de Bundesliga,33,2935,32.6,33,0,0,2,0,2,2,0,0,0,MF,07c7eb0c,Full Starter
2824,Anthony Losilla,2,2022-2023,36,fr FRA,Bochum,de Bundesliga,31,2720,30.2,31,0,0,2,2,4,2,0,0,0,MF,07c7eb0c,Full Starter
2825,Tom Bischof,2,2024-2025,19,de GER,Hoffenheim,de Bundesliga,17,1336,14.8,16,1,0,2,2,4,2,0,0,0,MFFW,07d3bfec,Rotational Player
2826,Martin Hinteregger,2,2020-2021,27,at AUT,Eint Frankfurt,de Bundesliga,29,2527,28.1,29,0,0,2,1,3,2,0,0,0,DF,080440a4,Full Starter
2827,Mattia Bani,2,2023-2024,29,it ITA,Genoa,it Serie A,27,2306,25.6,27,0,3,2,0,2,2,0,0,0,DF,0821331c,Full Starter
2828,Sergio Ramos,2,2020-2021,34,es ESP,Real Madrid,es La Liga,15,1275,14.2,15,0,1,2,0,2,0,2,2,0,DF,08511d65,Rotational Player
2829,Sergio Ramos,2,2021-2022,35,es ESP,Paris S-G,fr Ligue 1,12,801,8.9,8,4,2,2,0,2,2,0,0,0,DF,08511d65,Rotational Player
2830,Sergio Ramos,2,2022-2023,36,es ESP,Paris S-G,fr Ligue 1,33,2704,30.0,31,2,0,2,1,3,2,0,0,0,DF,08511d65,Rotational Player
2831,Diadie Samassékou,2,2021-2022,25,ml MLI,Hoffenheim,de Bundesliga,24,1655,18.4,21,3,6,2,0,2,2,0,0,0,MF,08593525,Rotational Player
2832,Jonathan Schmid,2,2020-2021,30,fr FRA,Freiburg,de Bundesliga,31,2393,26.6,27,4,0,2,2,4,2,0,0,0,MFDF,088ca1bd,Full Starter
2833,Matías Viña,2,2022-2023,24,uy URU,2 Teams,2 Comps,15,513,5.7,6,9,21,2,0,2,2,0,0,0,DF,08eb3b58,Bench Player
2834,Pontus Almqvist,2,2023-2024,24,se SWE,Lecce,it Serie A,30,2107,23.4,25,5,1,2,1,3,2,0,0,0,FWMF,0917188a,Rotational Player
2835,Felix Nmecha,2,2024-2025,23,de GER,Dortmund,de Bundesliga,19,1131,12.6,14,5,0,2,1,3,2,0,0,0,MF,091c86e2,Rotational Player
2836,Kevin Lasagna,2,2021-2022,28,it ITA,Hellas Verona,it Serie A,28,1184,13.2,11,17,6,2,4,6,2,0,0,0,MFFW,09538fdb,Rotational Player
2837,Federico Valverde,2,2023-2024,25,uy URU,Real Madrid,es La Liga,37,2904,32.3,33,4,1,2,7,9,2,0,0,0,MF,0959c2a2,Rotational Player
2838,Arber Zeneli,2,2021-2022,26,xk KVX,Reims,fr Ligue 1,9,409,4.5,4,5,1,2,3,5,2,0,0,0,FW,095e4199,Bench Player
2839,Fabiano Parisi,2,2022-2023,21,it ITA,Empoli,it Serie A,33,2830,31.4,33,0,2,2,0,2,2,0,0,0,DF,0967845b,Full Starter
2840,Simone Romagnoli,2,2021-2022,31,it ITA,Empoli,it Serie A,19,1497,16.6,17,2,14,2,0,2,2,0,0,0,DF,09899de8,Rotational Player
2841,Josip Juranović,2,2022-2023,26,hr CRO,Union Berlin,de Bundesliga,12,935,10.4,10,2,6,2,1,3,1,1,1,0,DF,0a084b35,Rotational Player
2842,Sergio León,2,2020-2021,31,es ESP,Levante,es La Liga,28,748,8.3,6,22,7,2,0,2,2,0,0,0,FW,0a0cc13c,Rotational Player
2843,Christopher Antwi-Adjei,2,2023-2024,29,gh GHA,Bochum,de Bundesliga,25,1216,13.5,11,14,2,2,2,4,2,0,0,0,FWMF,0a3f6cde,Rotational Player
2844,Antonio Sanabria,2,2024-2025,28,py PAR,Torino,it Serie A,17,975,10.8,13,4,5,2,0,2,2,0,1,1,FW,0a447501,Rotational Player
2845,Giorgos Kyriakopoulos,2,2024-2025,28,gr GRE,Monza,it Serie A,18,1599,17.8,18,0,0,2,3,5,2,0,0,0,DF,0a483542,Rotational Player
2846,Benjamin Henrichs,2,2022-2023,25,de GER,RB Leipzig,de Bundesliga,30,2188,24.3,23,7,3,2,2,4,2,0,0,0,DFMF,0a89e877,Rotational Player
2847,Juan Cuadrado,2,2020-2021,32,co COL,Juventus,it Serie A,30,2175,24.2,26,4,0,2,10,12,1,1,1,0,DFMF,0ab1f153,Full Starter
2848,Milos Kerkez,2,2024-2025,20,hu HUN,Bournemouth,eng Premier League,23,1997,22.2,23,0,0,2,3,5,2,0,0,0,DF,0ad53bdc,Rotational Player
2849,Roger Martí,2,2023-2024,32,es ESP,Cádiz,es La Liga,23,1359,15.1,18,5,2,2,3,5,2,0,0,0,FW,0ae4e09a,Rotational Player
2850,Romain Hamouma,2,2021-2022,34,fr FRA,Saint-Étienne,fr Ligue 1,22,886,9.8,7,15,0,2,1,3,2,0,0,0,FWMF,0b4d8274,Rotational Player
2851,Romain Hamouma,2,2022-2023,35,fr FRA,Ajaccio,fr Ligue 1,19,1079,12.0,14,5,1,2,2,4,2,0,0,0,FWMF,0b4d8274,Rotational Player
2852,Jérémy Sebas,2,2023-2024,20,mq MTQ,Strasbourg,fr Ligue 1,14,399,4.4,2,12,2,2,0,2,2,0,0,0,FWMF,0b6911e4,Bench Player
2853,Ansu Fati,2,2023-2024,20,es ESP,2 Teams,2 Comps,22,571,6.3,3,19,5,2,0,2,2,0,0,0,MFFW,0ba976e4,Bench Player
2854,Quentin Merlin,2,2021-2022,19,fr FRA,Nantes,fr Ligue 1,28,1926,21.4,21,7,5,2,3,5,2,0,0,0,DFMF,0bfca6a1,Rotational Player
2855,Dodi Lukebakio,2,2021-2022,23,be BEL,2 Teams,de Bundesliga,22,1058,11.8,9,13,10,2,2,4,1,1,1,0,FW,0c61c77c,Rotational Player
2856,Lukas Nmecha,2,2024-2025,25,de GER,Wolfsburg,de Bundesliga,9,215,2.4,1,8,1,2,0,2,2,0,0,0,FW,0cc5f4a5,Bench Player
2857,Seydouba Cissé,2,2024-2025,23,gn GUI,Leganés,es La Liga,19,1404,15.6,17,2,2,2,0,2,2,0,0,0,MF,0d13e455,Rotational Player
2858,Matěj Vydra,2,2021-2022,29,cz CZE,Burnley,eng Premier League,22,679,7.5,5,17,0,2,3,5,2,0,0,0,FW,0d4ceb32,Rotational Player
2859,Alex Sandro,2,2020-2021,29,br BRA,Juventus,it Serie A,26,1858,20.6,20,6,1,2,1,3,2,0,0,0,DF,0d82903c,Rotational Player
2860,Albert Grønbaek,2,2024-2025,23,dk DEN,Rennes,fr Ligue 1,16,813,9.0,9,7,1,2,1,3,2,0,0,0,MFFW,0da5076f,Bench Player
2861,Sandro Tonali,2,2022-2023,22,it ITA,Milan,it Serie A,34,2713,30.1,30,4,2,2,7,9,2,0,0,0,MF,0db169ae,Full Starter
2862,Dani Gómez,2,2024-2025,26,es ESP,Valencia,es La Liga,14,532,5.9,5,9,7,2,0,2,2,0,0,0,FW,0e5ddc7c,Rotational Player
2863,Dani Gómez,2,2020-2021,22,es ESP,Levante,es La Liga,34,1666,18.5,17,17,4,2,2,4,2,0,0,0,FW,0e5ddc7c,Rotational Player
2864,Eric Maxim Choupo-Moting,2,2023-2024,34,cm CMR,Bayern Munich,de Bundesliga,27,717,8.0,7,20,5,2,2,4,2,0,0,0,MFFW,0e6bc38c,Bench Player
2865,Philippe Coutinho,2,2020-2021,28,br BRA,Barcelona,es La Liga,12,654,7.3,8,4,1,2,2,4,2,0,0,0,MFFW,0ef89a37,Rotational Player
2866,Anton Stach,2,2023-2024,24,de GER,2 Teams,de Bundesliga,33,2491,27.7,28,5,0,2,3,5,2,0,0,0,MF,0f59a7bf,Full Starter
2867,Ibrahima Sissoko,2,2021-2022,23,ml MLI,Strasbourg,fr Ligue 1,35,2303,25.6,26,9,0,2,5,7,2,0,0,0,MFDF,0f8418aa,Full Starter
2868,Martin Erlic,2,2021-2022,23,hr CRO,Spezia,it Serie A,30,2576,28.6,30,0,0,2,0,2,2,0,0,0,DF,0fee6bda,Rotational Player
2869,Fernandinho,2,2021-2022,36,br BRA,Manchester City,eng Premier League,19,964,10.7,10,9,19,2,1,3,2,0,0,0,MFDF,101da2b5,Rotational Player
2870,Jeffrey Gouweleeuw,2,2021-2022,30,nl NED,Augsburg,de Bundesliga,29,2576,28.6,29,0,0,2,0,2,1,1,1,0,DF,1025db8e,Full Starter
2871,Tommaso Baldanzi,2,2023-2024,20,it ITA,2 Teams,it Serie A,27,1263,14.0,14,13,5,2,0,2,2,0,0,0,MFFW,102e2599,Rotational Player
2872,Jean-Ricner Bellegarde,2,2021-2022,23,fr FRA,Strasbourg,fr Ligue 1,36,2332,25.9,26,10,0,2,3,5,2,0,0,0,MF,10f0fdd3,Rotational Player
2873,Jean-Ricner Bellegarde,2,2022-2023,24,fr FRA,Strasbourg,fr Ligue 1,30,2419,26.9,29,1,0,2,6,8,2,0,0,0,MFFW,10f0fdd3,Rotational Player
2874,Alberto Moreno,2,2023-2024,31,es ESP,Villarreal,es La Liga,27,1484,16.5,17,10,3,2,2,4,2,0,0,0,DF,11b9265b,Rotational Player
2875,Fisayo Dele-Bashiru,2,2024-2025,23,ng NGA,Lazio,it Serie A,13,640,7.1,8,5,9,2,0,2,2,0,0,0,MFFW,121a4fb8,Bench Player
2876,Jens Petter Hauge,2,2020-2021,20,no NOR,Milan,it Serie A,18,532,5.9,3,15,17,2,0,2,2,0,0,0,FW,12c35abe,Bench Player
2877,Jens Petter Hauge,2,2021-2022,21,no NOR,Eint Frankfurt,de Bundesliga,26,1040,11.6,9,17,3,2,2,4,2,0,0,0,MFFW,12c35abe,Bench Player
2878,Olivier Deman,2,2023-2024,23,be BEL,Werder Bremen,de Bundesliga,29,1365,15.2,14,15,1,2,1,3,2,0,0,0,DF,13210854,Rotational Player
2879,Samuel Sáiz,2,2022-2023,31,es ESP,Girona,es La Liga,8,240,2.7,1,7,4,2,0,2,0,2,2,0,MF,13e0eb29,Bench Player
2880,Joel Asoro,2,2023-2024,24,se SWE,Metz,fr Ligue 1,20,848,9.4,10,10,4,2,1,3,2,0,0,0,FWMF,13e827f8,Rotational Player
2881,Christoph Klarer,2,2023-2024,23,at AUT,Darmstadt 98,de Bundesliga,30,2354,26.2,28,2,1,2,2,4,2,0,0,0,DF,144e8717,Full Starter
2882,Marco Verratti,2,2021-2022,28,it ITA,Paris S-G,fr Ligue 1,24,1937,21.5,23,1,0,2,2,4,2,0,0,0,MF,1467af0d,Rotational Player
2883,Rémy Cabella,2,2023-2024,33,fr FRA,Lille,fr Ligue 1,30,1477,16.4,14,16,1,2,2,4,2,0,0,0,FWMF,148e136f,Rotational Player
2884,Daniele Rugani,2,2023-2024,29,it ITA,Juventus,it Serie A,17,1187,13.2,13,4,21,2,0,2,2,0,0,0,DF,14b8fcdf,Rotational Player
2885,Salih Özcan,2,2021-2022,23,tr TUR,Köln,de Bundesliga,31,2312,25.7,26,5,2,2,0,2,2,0,0,0,MF,15413fa5,Full Starter
2886,Eray Cömert,2,2023-2024,25,ch SUI,Nantes,fr Ligue 1,25,1995,22.2,23,2,3,2,0,2,2,0,0,0,DF,15937e17,Rotational Player
2887,Daichi Kamada,2,2023-2024,26,jp JPN,Lazio,it Serie A,29,1544,17.2,17,12,9,2,2,4,2,0,0,0,MF,15b287da,Rotational Player
2888,Sasa Kalajdzic,2,2023-2024,26,at AUT,2 Teams,2 Comps,16,491,5.5,6,10,9,2,1,3,2,0,0,0,FW,15f24fe7,Rotational Player
2889,Callum Hudson-Odoi,2,2020-2021,19,eng ENG,Chelsea,eng Premier League,23,1059,11.8,10,13,10,2,3,5,2,0,0,0,FWDF,15f3ec41,Rotational Player
2890,Rodrigo De Paul,2,2022-2023,28,ar ARG,Atlético Madrid,es La Liga,30,1923,21.4,24,6,3,2,7,9,2,0,0,0,MF,162efffd,Rotational Player
2891,Bryan Cristante,2,2021-2022,26,it ITA,Roma,it Serie A,34,2678,29.8,29,5,0,2,0,2,2,0,0,0,MF,16657b95,Full Starter
2892,Hwang Hee-chan,2,2024-2025,28,kr KOR,Wolves,eng Premier League,16,608,6.8,5,11,3,2,0,2,2,0,0,0,MFFW,169fd162,Rotational Player
2893,Álex Moreno,2,2023-2024,30,es ESP,Aston Villa,eng Premier League,21,1031,11.5,11,10,4,2,0,2,2,0,0,0,DF,16e9d0ea,Rotational Player
2894,Riccardo Gagliolo,2,2020-2021,30,se SWE,Parma,it Serie A,28,1956,21.7,22,6,0,2,2,4,2,0,0,0,DF,173061c0,Rotational Player
2895,Emile Smith Rowe,2,2020-2021,20,eng ENG,Arsenal,eng Premier League,20,1440,16.0,18,2,3,2,4,6,2,0,0,0,MFFW,17695062,Rotational Player
2896,Mehdi Chahiri,2,2020-2021,24,ma MAR,Strasbourg,fr Ligue 1,23,801,8.9,8,15,9,2,0,2,2,0,0,0,FWMF,1787195f,Bench Player
2897,Arouna Sangante,2,2024-2025,22,sn SEN,Le Havre,fr Ligue 1,8,687,7.6,8,0,2,2,0,2,2,0,0,0,DF,17bb562c,Bench Player
2898,Álvaro Giménez,2,2020-2021,29,es ESP,Cádiz,es La Liga,11,407,4.5,3,8,5,2,1,3,2,0,0,0,FW,18017beb,Bench Player
2899,Williot Swedberg,2,2024-2025,20,se SWE,Celta Vigo,es La Liga,18,735,8.2,8,10,0,2,3,5,2,0,0,0,FWMF,184fe4b2,Bench Player
2900,Robert Glatzel,2,2020-2021,26,de GER,Mainz 05,de Bundesliga,13,359,4.0,3,10,2,2,1,3,2,0,0,0,FW,18a9efe4,Bench Player
2901,Raúl,2,2024-2025,23,es ESP,Osasuna,es La Liga,20,573,6.4,4,16,1,2,0,2,2,0,0,0,FWMF,18f0a9f0,Bench Player
2902,Sofiane Diop,2,2022-2023,22,fr FRA,2 Teams,fr Ligue 1,23,1293,14.4,15,8,2,2,4,6,2,0,0,0,MFFW,19053e31,Rotational Player
2903,Jim Allevinah,2,2023-2024,28,ga GAB,Clermont Foot,fr Ligue 1,29,1861,20.7,22,7,1,2,1,3,2,0,0,0,MFDF,1956b948,Rotational Player
2904,Óscar Rodríguez Arnaiz,2,2022-2023,24,es ESP,Celta Vigo,es La Liga,33,1775,19.7,19,14,3,2,0,2,2,0,0,0,MF,19709006,Rotational Player
2905,Óscar Rodríguez Arnaiz,2,2023-2024,25,es ESP,Getafe,es La Liga,24,967,10.7,9,15,9,2,1,3,2,0,0,0,MFFW,19709006,Rotational Player
2906,Timothy Castagne,2,2020-2021,24,be BEL,Leicester City,eng Premier League,27,2345,26.1,27,0,0,2,3,5,2,0,0,0,DF,197640fd,Full Starter
2907,Timothy Castagne,2,2022-2023,26,be BEL,Leicester City,eng Premier League,37,3254,36.2,36,1,1,2,3,5,2,0,0,0,DF,197640fd,Full Starter
2908,Hassane Kamara,2,2020-2021,26,ci CIV,Nice,fr Ligue 1,36,2960,32.9,34,2,0,2,1,3,2,0,0,0,DFFW,19a12bed,Full Starter
2909,Lamine Camara,2,2024-2025,20,sn SEN,Monaco,fr Ligue 1,16,1187,13.2,14,2,0,2,5,7,2,0,0,0,MF,19c2ffa4,Rotational Player
2910,Gavi,2,2021-2022,16,es ESP,Barcelona,es La Liga,34,2316,25.7,28,6,2,2,5,7,2,0,0,0,MFFW,19cae58d,Full Starter
2911,Gavi,2,2022-2023,17,es ESP,Barcelona,es La Liga,36,2531,28.1,30,6,0,2,4,6,2,0,0,0,MFFW,19cae58d,Full Starter
2912,Rodrigo Becão,2,2021-2022,25,br BRA,Udinese,it Serie A,35,3130,34.8,35,0,0,2,1,3,2,0,0,0,DF,19e4eab9,Full Starter
2913,Rodrigo Becão,2,2022-2023,26,br BRA,Udinese,it Serie A,28,2484,27.6,28,0,0,2,1,3,2,0,0,0,DF,19e4eab9,Full Starter
2914,Ezgjan Alioski,2,2020-2021,28,mk MKD,Leeds United,eng Premier League,36,2461,27.3,29,7,2,2,3,5,2,0,0,0,DFMF,1a7fcf39,Full Starter
2915,Julian Draxler,2,2021-2022,27,de GER,Paris S-G,fr Ligue 1,18,548,6.1,5,13,3,2,1,3,2,0,0,0,FWMF,1a992676,Bench Player
2916,Simone Bastoni,2,2022-2023,25,it ITA,Spezia,it Serie A,19,1189,13.2,15,4,3,2,4,6,2,0,0,0,MFDF,1ac232b8,Rotational Player
2917,Elvis Rexhbeçaj,2,2023-2024,25,xk KVX,Augsburg,de Bundesliga,25,1985,22.1,24,1,1,2,0,2,1,1,1,0,MF,1ae836b1,Rotational Player
2918,Frenkie de Jong,2,2022-2023,25,nl NED,Barcelona,es La Liga,33,2534,28.2,29,4,1,2,4,6,2,0,0,0,MF,1bacc518,Rotational Player
2919,Frenkie de Jong,2,2023-2024,26,nl NED,Barcelona,es La Liga,20,1634,18.2,20,0,1,2,0,2,2,0,0,0,MF,1bacc518,Rotational Player
2920,Frenkie de Jong,2,2024-2025,27,nl NED,Barcelona,es La Liga,10,357,4.0,2,8,3,2,1,3,2,0,0,0,MF,1bacc518,Rotational Player
2921,Declan Rice,2,2020-2021,21,eng ENG,West Ham,eng Premier League,32,2879,32.0,32,0,0,2,1,3,1,1,2,1,MF,1c7012b8,Full Starter
2922,Roberto Piccoli,2,2022-2023,21,it ITA,2 Teams,it Serie A,20,708,7.9,8,12,9,2,0,2,2,0,0,0,FW,1cadaf34,Rotational Player
2923,Andreas Christensen,2,2023-2024,27,dk DEN,Barcelona,es La Liga,30,1979,22.0,27,3,6,2,2,4,2,0,0,0,DFMF,1cb49278,Full Starter
2924,Can Uzun,2,2024-2025,18,tr TUR,Eint Frankfurt,de Bundesliga,12,318,3.5,2,10,7,2,1,3,2,0,0,0,MFFW,1d0b134a,Bench Player
2925,Álvaro Odriozola,2,2020-2021,24,es ESP,Real Madrid,es La Liga,13,829,9.2,9,4,13,2,0,2,2,0,0,0,DF,1d1691ad,Bench Player
2926,Enock Mwepu,2,2021-2022,23,zm ZAM,Brighton,eng Premier League,18,996,11.1,12,6,6,2,4,6,2,0,0,0,MF,1d5cab82,Rotational Player
2927,Marc Cucurella,2,2024-2025,26,es ESP,Chelsea,eng Premier League,21,1714,19.0,19,2,0,2,1,3,2,0,0,0,DF,1daec722,Full Starter
2928,Vladimir Golemić,2,2020-2021,29,si SVN,Crotone,it Serie A,30,2341,26.0,26,4,6,2,0,2,1,1,1,0,DF,1db295e5,Full Starter
2929,Melvin Bard,2,2021-2022,20,fr FRA,Nice,fr Ligue 1,33,2589,28.8,30,3,2,2,2,4,2,0,0,0,DF,1ddbc7ca,Full Starter
2930,Yerson Mosquera,2,2023-2024,22,co COL,2 Teams,2 Comps,16,1229,13.7,14,2,2,2,1,3,2,0,0,0,DF,1e159d70,Rotational Player
2931,Sven Michel,2,2023-2024,33,de GER,Augsburg,de Bundesliga,22,583,6.5,5,17,8,2,1,3,1,1,2,1,FWMF,1e274a0a,Bench Player
2932,Maximilian Breunig,2,2024-2025,23,de GER,Heidenheim,de Bundesliga,13,350,3.9,2,11,3,2,0,2,1,1,1,0,FWMF,1e37c986,Bench Player
2933,Johann Lepenant,2,2024-2025,21,fr FRA,Nantes,fr Ligue 1,15,1145,12.7,13,2,0,2,1,3,2,0,0,0,MF,1e52971c,Rotational Player
2934,Giorgio Scalvini,2,2022-2023,18,it ITA,Atalanta,it Serie A,32,2335,25.9,29,3,4,2,2,4,2,0,0,0,DF,1e9aa637,Full Starter
2935,Theo Walcott,2,2022-2023,33,eng ENG,Southampton,eng Premier League,20,1129,12.5,13,7,9,2,2,4,2,0,0,0,FWMF,1ecb65be,Rotational Player
2936,Merlin Röhl,2,2023-2024,21,de GER,Freiburg,de Bundesliga,24,1477,16.4,17,7,3,2,4,6,2,0,0,0,MFFW,1f2c7b55,Rotational Player
2937,Ajdin Hrustic,2,2021-2022,25,au AUS,Eint Frankfurt,de Bundesliga,23,964,10.7,9,14,6,2,0,2,2,0,0,0,MF,1f2d714c,Bench Player
2938,Federico Di Francesco,2,2022-2023,28,it ITA,Lecce,it Serie A,36,2031,22.6,23,13,0,2,2,4,2,0,0,0,FWMF,1fca9171,Rotational Player
2939,Rubén Duarte,2,2023-2024,27,es ESP,Alavés,es La Liga,28,1878,20.9,21,7,6,2,1,3,2,0,0,0,DF,1fe0492d,Rotational Player
2940,Willi Orban,2,2021-2022,28,hu HUN,RB Leipzig,de Bundesliga,30,2642,29.4,30,0,0,2,1,3,2,0,0,0,DF,20030c06,Full Starter
2941,Maxime Lopez,2,2021-2022,23,fr FRA,Sassuolo,it Serie A,35,2938,32.6,33,2,0,2,1,3,2,0,0,0,MF,20094685,Full Starter
2942,Maxime Lopez,2,2020-2021,22,fr FRA,2 Teams,2 Comps,33,1998,22.2,24,9,7,2,0,2,2,0,0,0,FWMF,20094685,Full Starter
2943,Dennis Man,2,2020-2021,21,ro ROU,Parma,it Serie A,14,699,7.8,8,6,0,2,1,3,2,0,0,0,FWMF,2079b3cc,Rotational Player
2944,Nicolás Domínguez,2,2023-2024,25,ar ARG,2 Teams,2 Comps,28,1597,17.7,20,8,6,2,2,4,2,0,0,0,MFFW,20b3a502,Rotational Player
2945,Davide Calabria,2,2020-2021,23,it ITA,Milan,it Serie A,32,2647,29.4,30,2,0,2,1,3,2,0,0,0,DF,2146785a,Full Starter
2946,Davide Calabria,2,2021-2022,24,it ITA,Milan,it Serie A,26,2119,23.5,24,2,1,2,2,4,2,0,0,0,DF,2146785a,Full Starter
2947,Kieran Trippier,2,2021-2022,30,eng ENG,2 Teams,2 Comps,21,1405,15.6,17,4,2,2,0,2,2,0,0,0,DF,21512407,Rotational Player
2948,Mikkel Damsgaard,2,2020-2021,20,dk DEN,Sampdoria,it Serie A,35,1773,19.7,18,17,2,2,4,6,2,0,0,0,MFFW,215f3907,Rotational Player
2949,Mikkel Damsgaard,2,2024-2025,24,dk DEN,Brentford,eng Premier League,23,1703,18.9,20,3,0,2,7,9,2,0,0,0,MFFW,215f3907,Rotational Player
2950,Lazar Samardzic,2,2021-2022,19,rs SRB,Udinese,it Serie A,22,490,5.4,1,21,15,2,2,4,2,0,0,0,MFFW,217c93a1,Rotational Player
2951,Lazar Samardzic,2,2024-2025,22,rs SRB,Atalanta,it Serie A,20,777,8.6,4,16,1,2,1,3,2,0,0,0,MFFW,217c93a1,Rotational Player
2952,Luca Caldirola,2,2020-2021,29,it ITA,Benevento,it Serie A,25,1572,17.5,17,8,4,2,0,2,2,0,0,0,DF,226008f1,Rotational Player
2953,Luca Caldirola,2,2022-2023,31,it ITA,Monza,it Serie A,31,2353,26.1,27,4,4,2,0,2,2,0,0,0,DF,226008f1,Rotational Player
2954,Aïssa Laïdouni,2,2022-2023,25,tn TUN,Union Berlin,de Bundesliga,14,871,9.7,11,3,2,2,0,2,2,0,0,0,MF,22798128,Rotational Player
2955,Armindo Sieb,2,2024-2025,21,de GER,Mainz 05,de Bundesliga,18,662,7.4,5,13,1,2,2,4,2,0,0,0,FWMF,228c1d94,Bench Player
2956,Sargis Adamyan,2,2020-2021,27,am ARM,Hoffenheim,de Bundesliga,18,479,5.3,3,15,6,2,3,5,2,0,0,0,FWMF,22919e97,Bench Player
2957,Sergio Córdova,2,2020-2021,22,ve VEN,Arminia,de Bundesliga,23,1090,12.1,13,10,1,2,1,3,2,0,0,0,FWMF,229cd98a,Rotational Player
2958,Diego Coppola,2,2023-2024,19,it ITA,Hellas Verona,it Serie A,24,1634,18.2,18,6,13,2,0,2,2,0,0,0,DF,22ae86f9,Rotational Player
2959,Ibrahim Sulemana,2,2023-2024,20,gh GHA,Cagliari,it Serie A,21,1339,14.9,16,5,12,2,0,2,2,0,0,0,MF,230c3f3a,Rotational Player
2960,Nelson Weiper,2,2022-2023,17,de GER,Mainz 05,de Bundesliga,9,99,1.1,0,9,7,2,0,2,2,0,0,0,FWDF,231c67ff,Bench Player
2961,Nahuel Molina,2,2020-2021,22,ar ARG,Udinese,it Serie A,29,1828,20.3,18,11,4,2,5,7,2,0,0,0,DF,23610943,Full Starter
2962,Nahuel Molina,2,2023-2024,25,ar ARG,Atlético Madrid,es La Liga,30,1852,20.6,19,11,2,2,3,5,2,0,0,0,DF,23610943,Full Starter
2963,Kike Pérez,2,2021-2022,24,es ESP,Elche,es La Liga,12,519,5.8,5,7,4,2,0,2,2,0,0,0,MFFW,237a3851,Bench Player
2964,Kike Pérez,2,2024-2025,27,es ESP,Valladolid,es La Liga,19,1191,13.2,14,5,1,2,0,2,2,0,0,0,MF,237a3851,Bench Player
2965,Matty Cash,2,2023-2024,25,pl POL,Aston Villa,eng Premier League,29,2142,23.8,23,6,2,2,2,4,2,0,0,0,DF,2389cdc2,Full Starter
2966,Ola Aina,2,2024-2025,27,ng NGA,Nott'ham Forest,eng Premier League,23,1991,22.1,23,0,0,2,1,3,2,0,0,0,DF,246d153b,Full Starter
2967,Ola Aina,2,2020-2021,23,ng NGA,Fulham,eng Premier League,31,2664,29.6,31,0,4,2,1,3,2,0,0,0,DF,246d153b,Full Starter
2968,Andrea Cambiaso,2,2024-2025,24,it ITA,Juventus,it Serie A,21,1504,16.7,17,4,0,2,0,2,2,0,0,0,DFFW,247ed022,Rotational Player
2969,Andrea Cambiaso,2,2023-2024,23,it ITA,Juventus,it Serie A,34,2372,26.4,28,6,1,2,3,5,2,0,0,0,DFFW,247ed022,Rotational Player
2970,Paul Baysse,2,2020-2021,32,fr FRA,Bordeaux,fr Ligue 1,31,2614,29.0,29,2,3,2,2,4,2,0,0,0,DF,2515040a,Full Starter
2971,Ezequiel Ávila,2,2024-2025,30,ar ARG,Betis,es La Liga,15,574,6.4,6,9,2,2,0,2,2,0,0,0,FW,253a06b9,Rotational Player
2972,Ezequiel Ávila,2,2023-2024,29,ar ARG,2 Teams,es La Liga,23,1162,12.9,14,9,0,2,3,5,2,0,0,0,FWMF,253a06b9,Rotational Player
2973,Elba Rashani,2,2023-2024,30,xk KVX,Clermont Foot,fr Ligue 1,24,1175,13.1,14,10,0,2,0,2,2,0,0,0,MFFW,25749008,Rotational Player
2974,Manuel Gulde,2,2020-2021,29,de GER,Freiburg,de Bundesliga,27,1954,21.7,22,5,7,2,0,2,2,0,0,0,DF,25ab9c9c,Rotational Player
2975,Aleksandar Pavlovic,2,2023-2024,19,de GER,Bayern Munich,de Bundesliga,19,1227,13.6,14,5,6,2,2,4,2,0,0,0,MF,2658c82f,Rotational Player
2976,Yacine Adli,2,2020-2021,20,fr FRA,Bordeaux,fr Ligue 1,35,2418,26.9,25,10,0,2,5,7,2,0,0,0,MF,26777636,Rotational Player
2977,Walace,2,2023-2024,28,br BRA,Udinese,it Serie A,37,3238,36.0,37,0,0,2,0,2,2,0,0,0,MF,26db8853,Full Starter
2978,Catena,2,2021-2022,26,es ESP,Rayo Vallecano,es La Liga,36,3240,36.0,36,0,0,2,2,4,2,0,0,0,DF,274ab13c,Full Starter
2979,Romain Thomas,2,2021-2022,33,fr FRA,Angers,fr Ligue 1,30,2563,28.5,29,1,2,2,0,2,2,0,0,0,DF,275e2c51,Full Starter
2980,Daniel Kyereh,2,2022-2023,26,gh GHA,Freiburg,de Bundesliga,12,559,6.2,7,5,2,2,0,2,2,0,0,0,MFFW,2770726a,Bench Player
2981,Aaron Connolly,2,2020-2021,20,ie IRL,Brighton,eng Premier League,17,791,8.8,9,8,11,2,1,3,2,0,0,0,FW,27c01749,Bench Player
2982,Pedro Porro,2,2024-2025,24,es ESP,Tottenham,eng Premier League,23,1898,21.1,20,3,0,2,5,7,2,0,0,0,DF,27d0a506,Rotational Player
2983,Edu Expósito,2,2022-2023,25,es ESP,Espanyol,es La Liga,28,1160,12.9,13,15,9,2,2,4,2,0,0,0,MF,283c7121,Rotational Player
2984,Nayef Aguerd,2,2022-2023,26,ma MAR,West Ham,eng Premier League,18,1595,17.7,17,1,3,2,0,2,2,0,0,0,DF,288e1e13,Full Starter
2985,Nayef Aguerd,2,2021-2022,25,ma MAR,Rennes,fr Ligue 1,31,2735,30.4,31,0,0,2,2,4,2,0,0,0,DF,288e1e13,Full Starter
2986,Michy Batshuayi,2,2020-2021,26,be BEL,Crystal Palace,eng Premier League,18,728,8.1,7,11,17,2,1,3,2,0,0,0,FW,2973d8ff,Bench Player
2987,Stéphane Diarra,2,2022-2023,23,fr FRA,Lorient,fr Ligue 1,28,1066,11.8,14,14,9,2,0,2,2,0,0,0,FWMF,29939a1d,Rotational Player
2988,Pere Pons,2,2020-2021,27,es ESP,Alavés,es La Liga,22,1186,13.2,12,10,3,2,0,2,2,0,0,0,MF,29b61deb,Rotational Player
2989,Abakar Sylla,2,2023-2024,20,ci CIV,Strasbourg,fr Ligue 1,22,1792,19.9,19,3,9,2,0,2,2,0,0,0,DF,29c91632,Rotational Player
2990,Joan Jordán,2,2024-2025,30,es ESP,Alavés,es La Liga,12,642,7.1,6,6,3,2,2,4,1,1,1,0,MF,2a0c8ba4,Bench Player
2991,Samuel Lino,2,2024-2025,24,br BRA,Atlético Madrid,es La Liga,17,847,9.4,10,7,4,2,2,4,2,0,0,0,MFDF,2a295d33,Rotational Player
2992,Lukas Kübler,2,2022-2023,29,de GER,Freiburg,de Bundesliga,22,1639,18.2,19,3,6,2,1,3,2,0,0,0,DF,2a29eb9b,Rotational Player
2993,Lukas Kübler,2,2021-2022,28,de GER,Freiburg,de Bundesliga,29,2327,25.9,27,2,1,2,0,2,2,0,0,0,DFMF,2a29eb9b,Rotational Player
2994,Grigoris Kastanos,2,2022-2023,24,cy CYP,Salernitana,it Serie A,28,1286,14.3,13,15,9,2,1,3,2,0,0,0,MFDF,2a82aa85,Rotational Player
2995,Luke Berry,2,2023-2024,31,eng ENG,Luton Town,eng Premier League,17,323,3.6,2,15,16,2,1,3,2,0,0,0,MFDF,2aaadf33,Bench Player
2996,Moussa Sissoko,2,2021-2022,31,fr FRA,2 Teams,eng Premier League,36,3220,35.8,36,0,1,2,1,3,2,0,0,0,MF,2acd49b9,Full Starter
2997,Moussa Sissoko,2,2022-2023,32,fr FRA,Nantes,fr Ligue 1,30,1918,21.3,22,8,2,2,0,2,2,0,0,0,MF,2acd49b9,Full Starter
2998,Haris Belkebla,2,2022-2023,28,dz ALG,Brest,fr Ligue 1,38,2656,29.5,30,8,0,2,0,2,1,1,1,0,MF,2b1bed19,Full Starter
2999,Mario Lemina,2,2021-2022,27,ga GAB,Nice,fr Ligue 1,32,1967,21.9,24,8,1,2,0,2,2,0,0,0,MF,2b471f99,Full Starter
3000,Dilane Bakwa,2,2024-2025,21,fr FRA,Strasbourg,fr Ligue 1,18,1553,17.3,18,0,0,2,5,7,2,0,0,0,MFFW,2b5a35e5,Rotational Player
